predicted_phred,program,nfrags,fraglen,qual_shift,observed_phred,n_matches,n_mismatches,n_total,observed_phred_unrounded
1,AdapterRemoval,10000000,120,0,0,0,1,1,0.0
2,AdapterRemoval,10000000,120,0,3,16448,16621,33069,2.9876391263603734
3,AdapterRemoval,10000000,120,0,3,164014,153358,317372,3.158621725688163
4,AdapterRemoval,10000000,120,0,4,59493,34734,94227,4.334205643165464
5,AdapterRemoval,10000000,120,0,5,34447,13768,48215,5.443113137779489
6,AdapterRemoval,10000000,120,0,6,36411,11047,47458,6.330650779919721
7,AdapterRemoval,10000000,120,0,8,21079,4123,25202,7.8622167242851155
8,AdapterRemoval,10000000,120,0,9,10933,1751,12684,8.599700872716049
9,AdapterRemoval,10000000,120,0,10,36105,4366,40471,9.670602041554949
10,AdapterRemoval,10000000,120,0,10,32699,3233,35932,10.458756863974415
11,AdapterRemoval,10000000,120,0,11,43632,3375,47007,11.43888758109275
12,AdapterRemoval,10000000,120,0,12,33251,2077,35328,12.30682555177987
13,AdapterRemoval,10000000,120,0,13,64865,3293,68158,13.159251074770847
14,AdapterRemoval,10000000,120,0,14,35049,1413,36462,14.116983248824015
15,AdapterRemoval,10000000,120,0,15,44741,1387,46128,15.218881639708478
16,AdapterRemoval,10000000,120,0,16,20054,482,20536,16.294688174245373
17,AdapterRemoval,10000000,120,0,17,39138,808,39946,16.940619368954234
18,AdapterRemoval,10000000,120,0,18,68982,1084,70066,18.104780425480424
19,AdapterRemoval,10000000,120,0,19,115346,1436,116782,19.10221468768244
20,AdapterRemoval,10000000,120,0,20,150407,1534,151941,19.958496207747245
21,AdapterRemoval,10000000,120,0,21,144503,1171,145674,20.948251504234953
22,AdapterRemoval,10000000,120,0,22,889807,5472,895279,22.138123089260734
23,AdapterRemoval,10000000,120,0,23,838525,4139,842664,23.08759014138124
24,AdapterRemoval,10000000,120,0,24,632599,2530,635129,23.99741421908773
25,AdapterRemoval,10000000,120,0,25,272906,884,273790,24.90965316753745
26,AdapterRemoval,10000000,120,0,100,725,0,725,100.0
27,AdapterRemoval,10000000,120,0,30,954,1,955,29.800033715837465
28,AdapterRemoval,10000000,120,0,30,1037,1,1038,30.16197353512439
29,AdapterRemoval,10000000,120,0,100,491,0,491,100.0
30,AdapterRemoval,10000000,120,0,31,1405,1,1406,31.47985320683805
31,AdapterRemoval,10000000,120,0,33,48389,27,48416,32.53625142184105
32,AdapterRemoval,10000000,120,0,33,130439,63,130502,33.16276618023845
33,AdapterRemoval,10000000,120,0,34,410554,181,410735,33.55883137137659
34,AdapterRemoval,10000000,120,0,34,502630,188,502818,34.27252967007101
35,AdapterRemoval,10000000,120,0,35,712475,224,712699,35.02658131097298
36,AdapterRemoval,10000000,120,0,37,361782,77,361859,36.720486535077875
37,AdapterRemoval,10000000,120,0,39,136975,19,136994,38.57947945590777
38,AdapterRemoval,10000000,120,0,100,1777,0,1777,100.0
39,AdapterRemoval,10000000,120,0,41,12379,1,12380,40.92720644684099
40,AdapterRemoval,10000000,120,0,40,64691,7,64698,39.6579281557888
41,AdapterRemoval,10000000,120,0,65,1193532649,337,1193532986,65.49204525353561
1,AdapterRemoval,10000000,120,-10,0,0,3,3,0.0
2,AdapterRemoval,10000000,120,-10,3,209139,245432,454571,2.6767053942563734
3,AdapterRemoval,10000000,120,-10,3,1586750,1506290,3093040,3.124769435517285
4,AdapterRemoval,10000000,120,-10,4,397732,225477,623209,4.415314686792562
5,AdapterRemoval,10000000,120,-10,5,342558,135638,478196,5.472245615966084
6,AdapterRemoval,10000000,120,-10,6,352714,106625,459339,6.3427427641268705
7,AdapterRemoval,10000000,120,-10,8,227978,45883,273861,7.758783837096281
8,AdapterRemoval,10000000,120,-10,9,161077,24967,186044,8.722493071319876
9,AdapterRemoval,10000000,120,-10,10,420708,51150,471858,9.649656845374025
10,AdapterRemoval,10000000,120,-10,10,431689,42728,474417,10.454476779455288
11,AdapterRemoval,10000000,120,-10,12,673599,50804,724403,11.540823328538101
12,AdapterRemoval,10000000,120,-10,12,341746,20583,362329,12.455944213352545
13,AdapterRemoval,10000000,120,-10,13,1016166,50046,1066212,13.284741945342448
14,AdapterRemoval,10000000,120,-10,14,530821,19914,550735,14.41784174603972
15,AdapterRemoval,10000000,120,-10,15,458942,13721,472663,15.371658427822512
16,AdapterRemoval,10000000,120,-10,17,196545,4371,200916,16.62433716794295
17,AdapterRemoval,10000000,120,-10,18,389011,7017,396028,17.515744160017622
18,AdapterRemoval,10000000,120,-10,19,689632,9808,699440,18.53170008205996
19,AdapterRemoval,10000000,120,-10,20,1192760,13481,1206241,19.517119773119973
20,AdapterRemoval,10000000,120,-10,20,1594539,14410,1608949,20.478782973623492
21,AdapterRemoval,10000000,120,-10,22,1588886,11151,1600037,21.568162097843096
22,AdapterRemoval,10000000,120,-10,22,9042181,52316,9094497,22.40144152925154
23,AdapterRemoval,10000000,120,-10,24,8685874,38899,8724773,23.50815699561683
24,AdapterRemoval,10000000,120,-10,25,6658772,23178,6681950,24.598272630272643
25,AdapterRemoval,10000000,120,-10,26,3100517,8391,3108908,25.687941493329888
26,AdapterRemoval,10000000,120,-10,26,414179,950,415129,26.40459468007888
27,AdapterRemoval,10000000,120,-10,28,947355,1678,949033,27.524893575876426
28,AdapterRemoval,10000000,120,-10,29,1017154,1430,1018584,28.526608124957672
29,AdapterRemoval,10000000,120,-10,29,685490,792,686282,29.377774266510386
30,AdapterRemoval,10000000,120,-10,31,1238654,1065,1239719,30.659736495011437
31,AdapterRemoval,10000000,120,-10,31,1139059,841,1139900,31.320707578604008
32,AdapterRemoval,10000000,120,-10,33,4844806,2671,4847477,32.588418691214734
33,AdapterRemoval,10000000,120,-10,34,1592473,703,1593176,33.553084304465195
34,AdapterRemoval,10000000,120,-10,34,10583172,3767,10586939,34.487747905584534
35,AdapterRemoval,10000000,120,-10,36,1966173,514,1966687,35.82772128067282
36,AdapterRemoval,10000000,120,-10,36,18794375,4586,18798961,36.126997965061406
37,AdapterRemoval,10000000,120,-10,38,24734819,4365,24739184,37.534011226702
38,AdapterRemoval,10000000,120,-10,38,531842,82,531924,38.120357334104895
39,AdapterRemoval,10000000,120,-10,40,680437,69,680506,39.93982867979768
40,AdapterRemoval,10000000,120,-10,40,2079070,207,2079277,40.01942004171816
41,AdapterRemoval,10000000,120,-10,56,1085712160,2443,1085714603,56.47792212209927
1,AdapterRemoval,10000000,120,-20,0,15228,2413869,2429097,0.02731160270855362
2,AdapterRemoval,10000000,120,-20,3,10900397,11028493,21928890,2.985004771783777
3,AdapterRemoval,10000000,120,-20,3,2011212,1636531,3647743,3.4809999637460107
4,AdapterRemoval,10000000,120,-20,4,3098351,1795695,4894046,4.354354736591431
5,AdapterRemoval,10000000,120,-20,5,3684001,1498919,5182920,5.387963407522152
6,AdapterRemoval,10000000,120,-20,6,3063366,938869,4002235,6.296975860359414
7,AdapterRemoval,10000000,120,-20,8,2464339,527391,2991730,7.537896821857213
8,AdapterRemoval,10000000,120,-20,8,1213077,206323,1419400,8.375571569414792
9,AdapterRemoval,10000000,120,-20,9,3425428,443460,3868888,9.407317048993288
10,AdapterRemoval,10000000,120,-20,11,3289593,300537,3590130,10.772122279247542
11,AdapterRemoval,10000000,120,-20,12,2795109,206510,3001619,11.624144790628367
12,AdapterRemoval,10000000,120,-20,13,4958095,277914,5236009,12.750899593320614
13,AdapterRemoval,10000000,120,-20,15,9058587,318964,9377551,14.683477657465186
14,AdapterRemoval,10000000,120,-20,13,3518458,191651,3710109,12.868755793571383
15,AdapterRemoval,10000000,120,-20,16,2089117,55909,2145026,15.839508362176492
16,AdapterRemoval,10000000,120,-20,17,7357654,136880,7494534,17.384046376465403
17,AdapterRemoval,10000000,120,-20,11,491487,38128,529615,11.427162518918298
18,AdapterRemoval,10000000,120,-20,18,80813341,1297603,82110944,18.01259204148368
19,AdapterRemoval,10000000,120,-20,19,271519,3133,274652,19.428223709945193
20,AdapterRemoval,10000000,120,-20,21,643555,5782,649337,20.503920628629423
21,AdapterRemoval,10000000,120,-20,22,643563,4321,647884,21.75912988526037
22,AdapterRemoval,10000000,120,-20,23,2337382,12776,2350158,22.647021575334346
23,AdapterRemoval,10000000,120,-20,23,1033159,4690,1037849,23.449613284879653
24,AdapterRemoval,10000000,120,-20,25,3500240,12376,3512616,24.530503745216265
25,AdapterRemoval,10000000,120,-20,26,1646562,4492,1651054,25.653215301061447
26,AdapterRemoval,10000000,120,-20,26,8348260,20208,8368468,26.1712262656889
27,AdapterRemoval,10000000,120,-20,27,5120015,9216,5129231,27.455097923093376
28,AdapterRemoval,10000000,120,-20,29,10144988,13646,10158634,28.718299466982565
29,AdapterRemoval,10000000,120,-20,30,10367640,10697,10378337,29.868657729698572
30,AdapterRemoval,10000000,120,-20,30,2104197,2017,2106214,30.187965969830813
31,AdapterRemoval,10000000,120,-20,31,17528253,13387,17541640,31.17386930525132
32,AdapterRemoval,10000000,120,-20,32,6635512,3926,6639438,32.28181024491315
33,AdapterRemoval,10000000,120,-20,33,20061964,9098,20071062,33.43624419990435
34,AdapterRemoval,10000000,120,-20,34,11685024,4186,11689210,34.45985936925282
35,AdapterRemoval,10000000,120,-20,35,43137114,12529,43149643,35.37060797678992
36,AdapterRemoval,10000000,120,-20,36,72873811,16324,72890135,36.49842168485988
37,AdapterRemoval,10000000,120,-20,38,31566213,5601,31571814,37.5103396289967
38,AdapterRemoval,10000000,120,-20,39,49823208,6904,49830112,38.58391080601317
39,AdapterRemoval,10000000,120,-20,40,70953572,7646,70961218,39.675867675676514
40,AdapterRemoval,10000000,120,-20,41,661771311,56857,661828168,40.65961306313688
1,AdapterRemoval,10000000,120,-30,0,6292,162213,168505,0.16527135793307376
2,AdapterRemoval,10000000,120,-30,3,1278093,1441820,2719913,2.75643967292159
3,AdapterRemoval,10000000,120,-30,3,394253,329712,723965,3.415828170386492
4,AdapterRemoval,10000000,120,-30,4,235746,150392,386138,4.095178079555337
5,AdapterRemoval,10000000,120,-30,5,409557,171926,581483,5.291954633174754
6,AdapterRemoval,10000000,120,-30,6,312182,103800,415982,6.028771851195839
7,AdapterRemoval,10000000,120,-30,7,168281,44942,213223,6.761816540833079
8,AdapterRemoval,10000000,120,-30,7,1931885,430799,2362684,7.391309537678136
9,AdapterRemoval,10000000,120,-30,10,17980,2081,20061,9.840804977079356
10,AdapterRemoval,10000000,120,-30,10,74278,7979,82257,10.13224401208701
11,AdapterRemoval,10000000,120,-30,11,56400,4475,60875,11.336459345707599
12,AdapterRemoval,10000000,120,-30,12,434471,27335,461806,12.277404929476996
13,AdapterRemoval,10000000,120,-30,14,868710,36796,905506,13.91090722165234
14,AdapterRemoval,10000000,120,-30,14,30276,1124,31400,14.461633368401724
15,AdapterRemoval,10000000,120,-30,15,415849,12261,428110,15.430294799816481
16,AdapterRemoval,10000000,120,-30,17,712295,15181,727476,16.80518289914154
18,AdapterRemoval,10000000,120,-30,18,1077009,16937,1093946,18.101593971012548
19,AdapterRemoval,10000000,120,-30,19,10502299,126091,10628390,19.257833930754266
0,bbmerge,10000000,120,0,0,0,239825,239825,0.0
1,bbmerge,10000000,120,0,4,50781,40705,91486,3.5170688047471765
2,bbmerge,10000000,120,0,4,32994,21027,54021,4.097853045866222
3,bbmerge,10000000,120,0,5,23621,12066,35687,4.709467198806512
4,bbmerge,10000000,120,0,5,32319,12979,45298,5.428377950076387
5,bbmerge,10000000,120,0,6,25706,8216,33922,6.158210192265225
6,bbmerge,10000000,120,0,7,8536,2158,10694,6.9508873941743
7,bbmerge,10000000,120,0,8,19823,3889,23712,7.851302431517744
8,bbmerge,10000000,120,0,9,10304,1654,11958,8.591230438676034
9,bbmerge,10000000,120,0,10,33987,4095,38082,9.684658426011627
10,bbmerge,10000000,120,0,10,30898,3045,33943,10.47162927160887
11,bbmerge,10000000,120,0,11,41720,3227,44947,11.439017445268465
12,bbmerge,10000000,120,0,12,31904,1984,33888,12.325042706092312
13,bbmerge,10000000,120,0,13,62069,3134,65203,13.181685860145684
14,bbmerge,10000000,120,0,14,34434,1357,35791,14.211939850810566
15,bbmerge,10000000,120,0,15,41162,1266,42428,15.252188544982996
16,bbmerge,10000000,120,0,16,19797,466,20263,16.383178277396407
17,bbmerge,10000000,120,0,23,159848,828,160676,22.879206747266405
18,bbmerge,10000000,120,0,26,495697,1181,496878,26.239998705344775
19,bbmerge,10000000,120,0,29,1290942,1814,1292756,28.52879279392701
20,bbmerge,10000000,120,0,25,465586,1542,467128,24.8135152628755
21,bbmerge,10000000,120,0,24,259889,1140,261029,23.597839082636103
22,bbmerge,10000000,120,0,22,847264,5211,852475,22.13760578402467
23,bbmerge,10000000,120,0,23,801770,3958,805728,23.087126662822964
24,bbmerge,10000000,120,0,24,629090,2424,631514,24.15850367354902
25,bbmerge,10000000,120,0,26,315384,858,316242,25.665322600907405
26,bbmerge,10000000,120,0,43,84898,4,84902,43.26857929525333
27,bbmerge,10000000,120,0,43,252732,12,252744,43.2349960843175
28,bbmerge,10000000,120,0,43,459942,24,459966,42.825144887566815
29,bbmerge,10000000,120,0,45,443484,15,443499,44.70801385867483
30,bbmerge,10000000,120,0,49,507928,7,507935,48.6071009953841
31,bbmerge,10000000,120,0,47,738966,14,738980,47.225046489856325
32,bbmerge,10000000,120,0,49,860010,12,860022,48.55328314912682
33,bbmerge,10000000,120,0,49,783168,9,783177,49.39617415372412
34,bbmerge,10000000,120,0,54,919878,4,919882,53.61672129457134
35,bbmerge,10000000,120,0,50,1291925,12,1291937,50.320600901970025
36,bbmerge,10000000,120,0,50,2745287,30,2745317,49.61471244668287
37,bbmerge,10000000,120,0,53,5213890,25,5213915,53.19223938119639
38,bbmerge,10000000,120,0,55,3118121,10,3118131,54.93894356966362
39,bbmerge,10000000,120,0,56,4658010,11,4658021,56.26808756997406
40,bbmerge,10000000,120,0,57,6886764,13,6886777,57.2407266806233
41,bbmerge,10000000,120,0,69,1150058382,159,1150058541,68.5932282332549
0,bbmerge,10000000,120,-10,0,0,2104149,2104149,0.0
1,bbmerge,10000000,120,-10,3,384287,345680,729967,3.246289738832429
2,bbmerge,10000000,120,-10,4,264143,178639,442782,3.942136786595907
3,bbmerge,10000000,120,-10,5,197587,102547,300134,4.663922366198216
4,bbmerge,10000000,120,-10,6,308328,119339,427667,5.543233457974386
5,bbmerge,10000000,120,-10,6,274997,80275,355272,6.4598066661225
6,bbmerge,10000000,120,-10,9,303993,41454,345447,9.208149823816614
7,bbmerge,10000000,120,-10,11,851245,71343,922588,11.116564338560035
8,bbmerge,10000000,120,-10,9,111194,15626,126820,9.093399288773853
9,bbmerge,10000000,120,-10,10,351851,39782,391633,9.931926663836144
10,bbmerge,10000000,120,-10,11,283343,27653,310996,10.510125495665498
11,bbmerge,10000000,120,-10,11,375804,28925,404729,11.458909563347351
12,bbmerge,10000000,120,-10,13,320272,17457,337729,12.865987421757819
13,bbmerge,10000000,120,-10,14,578471,26909,605380,13.521305103398902
14,bbmerge,10000000,120,-10,16,431718,11992,443710,15.682075967868112
15,bbmerge,10000000,120,-10,17,539030,12319,551349,16.50851135994521
16,bbmerge,10000000,120,-10,20,566984,5814,572798,19.935264654713954
17,bbmerge,10000000,120,-10,19,538905,6879,545784,18.994954904559833
18,bbmerge,10000000,120,-10,21,1095208,9769,1104977,20.5350312871022
19,bbmerge,10000000,120,-10,21,1470307,12516,1482823,20.736237592575378
20,bbmerge,10000000,120,-10,22,2084322,13237,2097559,21.999246166195405
21,bbmerge,10000000,120,-10,22,1627613,9243,1636856,22.48197521637296
22,bbmerge,10000000,120,-10,23,8855822,46227,8902049,22.84594270578588
23,bbmerge,10000000,120,-10,24,8378462,33958,8412420,23.939788432261658
24,bbmerge,10000000,120,-10,26,7843919,21252,7865171,25.683083620037543
25,bbmerge,10000000,120,-10,29,5787669,8122,5795791,28.5344973098548
26,bbmerge,10000000,120,-10,36,2674169,740,2674909,35.580772922449285
27,bbmerge,10000000,120,-10,37,4572424,859,4573283,37.26234913021895
28,bbmerge,10000000,120,-10,36,9061098,2163,9063261,36.22227967364802
29,bbmerge,10000000,120,-10,37,52306345,11016,52317361,36.766219018738575
30,bbmerge,10000000,120,-10,45,8436904,252,8437156,45.247955383497036
31,bbmerge,10000000,120,-10,48,24602715,379,24603094,48.12350515941546
32,bbmerge,10000000,120,-10,51,46952945,382,46953327,50.89603007844821
33,bbmerge,10000000,120,-10,56,71484541,181,71484722,55.965346576998755
34,bbmerge,10000000,120,-10,58,210115699,317,210116016,58.21399895353928
35,bbmerge,10000000,120,-10,61,628834482,529,628835011,60.750810414364
0,bbmerge,10000000,120,-20,0,0,389616,389616,0.0
1,bbmerge,10000000,120,-20,4,32283,25777,58060,3.5264465995458543
2,bbmerge,10000000,120,-20,2,29758,46473,76231,2.149309082311601
3,bbmerge,10000000,120,-20,5,30720,15658,46378,4.715757275074695
4,bbmerge,10000000,120,-20,5,57827,23434,81261,5.400357368763757
5,bbmerge,10000000,120,-20,6,48189,16025,64214,6.028316855150898
6,bbmerge,10000000,120,-20,7,24019,5582,29601,7.245165507693674
7,bbmerge,10000000,120,-20,8,44423,8588,53011,7.904739610746586
8,bbmerge,10000000,120,-20,8,18326,3259,21585,8.210676925271423
9,bbmerge,10000000,120,-20,10,65034,7694,72728,9.755494627860262
10,bbmerge,10000000,120,-20,11,54019,4186,58205,11.431610695671273
11,bbmerge,10000000,120,-20,12,104472,6383,110855,12.397304418654267
12,bbmerge,10000000,120,-20,15,128731,4618,133349,14.605358346310117
13,bbmerge,10000000,120,-20,13,117183,5517,122700,13.471415787692642
14,bbmerge,10000000,120,-20,14,121745,4785,126530,14.223115659268812
15,bbmerge,10000000,120,-20,18,193459,2801,196260,18.45518685685057
16,bbmerge,10000000,120,-20,20,1504336,16096,1520432,19.75249038095336
17,bbmerge,10000000,120,-20,22,211880,1230,213110,22.38698717640937
18,bbmerge,10000000,120,-20,13,313595,15225,328820,13.34400923698986
19,bbmerge,10000000,120,-20,28,1021672,1675,1023347,27.86008109369956
20,bbmerge,10000000,120,-20,32,1648915,1013,1649928,32.118555474081994
21,bbmerge,10000000,120,-20,36,5028291,1208,5029499,36.19457791849945
22,bbmerge,10000000,120,-20,40,26106967,2433,26109400,40.30654782820001
2,ClipAndMerge,10000000,120,0,2,3905,6783,10688,1.974746280664483
13,ClipAndMerge,10000000,120,0,13,67851,3570,71421,13.01157710554448
14,ClipAndMerge,10000000,120,0,14,1224648,50860,1275508,13.993068310143585
15,ClipAndMerge,10000000,120,0,15,1650538,53620,1704158,15.02183048006285
16,ClipAndMerge,10000000,120,0,16,4600203,119050,4719253,15.981438608312558
18,ClipAndMerge,10000000,120,0,18,375431,6074,381505,17.980254466042748
21,ClipAndMerge,10000000,120,0,21,71728,573,72301,21.009896821249075
22,ClipAndMerge,10000000,120,0,22,16991,110,17101,21.916288218294685
23,ClipAndMerge,10000000,120,0,23,249339,1227,250566,23.10077577298405
24,ClipAndMerge,10000000,120,0,24,441143,1825,442968,23.851094851385138
25,ClipAndMerge,10000000,120,0,25,1584339,5041,1589380,24.98711046322448
26,ClipAndMerge,10000000,120,0,26,740959,1815,742774,26.11980063953348
27,ClipAndMerge,10000000,120,0,27,1630799,3268,1634067,26.98987811639413
28,ClipAndMerge,10000000,120,0,28,1673011,2664,1675675,27.986555698142173
29,ClipAndMerge,10000000,120,0,29,2729242,3438,2732680,29.00282905931121
30,ClipAndMerge,10000000,120,0,30,532072,509,532581,30.196678864459543
31,ClipAndMerge,10000000,120,0,31,3087164,2436,3089600,31.03224972474482
32,ClipAndMerge,10000000,120,0,32,1864898,1198,1866096,31.924771639069363
33,ClipAndMerge,10000000,120,0,33,10799155,5361,10804516,33.04359509737849
34,ClipAndMerge,10000000,120,0,34,22420727,8930,22429657,33.99971173403905
35,ClipAndMerge,10000000,120,0,35,8962104,2842,8964946,34.989236043588804
36,ClipAndMerge,10000000,120,0,36,14801337,3703,14805040,36.018558730467504
37,ClipAndMerge,10000000,120,0,37,23441790,4665,23446455,37.01225540532726
38,ClipAndMerge,10000000,120,0,38,1041635813,164091,1041799904,38.02699551387474
0,ClipAndMerge,10000000,120,-10,0,0,10688,10688,0.0
3,ClipAndMerge,10000000,120,-10,3,35265,35263,70528,3.0104231135816732
4,ClipAndMerge,10000000,120,-10,4,767027,505808,1272835,4.00786414905142
5,ClipAndMerge,10000000,120,-10,5,1157826,535290,1693116,5.000975836258244
6,ClipAndMerge,10000000,120,-10,6,3529408,1184268,4713676,5.999097330721605
8,ClipAndMerge,10000000,120,-10,8,321908,59905,381813,8.043876387005483
11,ClipAndMerge,10000000,120,-10,11,66435,5794,72229,10.95733111290233
12,ClipAndMerge,10000000,120,-10,12,16191,1069,17260,12.080630861704126
13,ClipAndMerge,10000000,120,-10,13,236387,12742,249129,12.911866840241633
14,ClipAndMerge,10000000,120,-10,14,422917,17565,440482,13.992800118313813
15,ClipAndMerge,10000000,120,-10,15,1537718,50143,1587861,15.006021682298032
16,ClipAndMerge,10000000,120,-10,16,721542,18627,740169,15.991879773108904
17,ClipAndMerge,10000000,120,-10,17,1601081,32688,1633769,16.98802301979448
18,ClipAndMerge,10000000,120,-10,18,1647897,26545,1674442,17.998873791911258
19,ClipAndMerge,10000000,120,-10,19,2692719,34395,2727114,18.992079791014124
20,ClipAndMerge,10000000,120,-10,20,526935,5324,532259,19.998849668817783
21,ClipAndMerge,10000000,120,-10,21,3058048,24483,3082531,21.00042820270842
22,ClipAndMerge,10000000,120,-10,22,1852362,11623,1863985,22.05124175341135
23,ClipAndMerge,10000000,120,-10,23,10742903,53085,10795988,23.08290571462802
24,ClipAndMerge,10000000,120,-10,24,22295527,88419,22383946,24.0339105061839
25,ClipAndMerge,10000000,120,-10,25,8920348,28238,8948586,25.009204823285522
26,ClipAndMerge,10000000,120,-10,26,14728796,36888,14765684,26.023684606502016
27,ClipAndMerge,10000000,120,-10,27,23345564,46489,23392053,27.017181348641262
28,ClipAndMerge,10000000,120,-10,28,1038183124,1634493,1039817617,28.035741061693553
0,ClipAndMerge,10000000,120,-20,0,0,6469926,6469926,0.0
1,ClipAndMerge,10000000,120,-20,1,12720,49507,62227,0.9931225392587866
2,ClipAndMerge,10000000,120,-20,2,5168,8787,13955,2.0088921442338874
3,ClipAndMerge,10000000,120,-20,3,105185,105195,210380,3.010093528195776
4,ClipAndMerge,10000000,120,-20,4,214630,142655,357285,3.987277853680711
5,ClipAndMerge,10000000,120,-20,5,882521,408096,1290617,5.00035043326609
6,ClipAndMerge,10000000,120,-20,6,459933,154624,614557,5.992852658565102
7,ClipAndMerge,10000000,120,-20,7,1073157,267319,1340476,7.002292149173312
8,ClipAndMerge,10000000,120,-20,8,1161702,218908,1380610,7.998093815707109
9,ClipAndMerge,10000000,120,-20,9,1968979,283393,2252372,9.002510011659687
10,ClipAndMerge,10000000,120,-20,10,398121,44228,442349,10.000677488965703
11,ClipAndMerge,10000000,120,-20,11,2364250,203286,2567536,11.014090711902561
12,ClipAndMerge,10000000,120,-20,12,1460203,97547,1557750,12.032838424595141
13,ClipAndMerge,10000000,120,-20,13,8586449,446518,9032967,13.059914528100316
14,ClipAndMerge,10000000,120,-20,14,18138070,728478,18866548,14.132760042232286
15,ClipAndMerge,10000000,120,-20,15,7410678,227854,7638532,15.253532452818714
16,ClipAndMerge,10000000,120,-20,16,12298080,296883,12594963,16.27611566112121
17,ClipAndMerge,10000000,120,-20,17,19602861,373757,19976618,17.279326297581505
18,ClipAndMerge,10000000,120,-20,18,893533861,12931351,906465212,18.457072414824825
0,ClipAndMerge,10000000,120,-30,0,0,11071022,11071022,0.0
1,ClipAndMerge,10000000,120,-30,1,455231,1752985,2208216,1.0026335238464728
2,ClipAndMerge,10000000,120,-30,2,478905,819970,1298875,1.9976939455970668
3,ClipAndMerge,10000000,120,-30,3,3699561,3717473,7417034,2.999824469154018
4,ClipAndMerge,10000000,120,-30,4,10262369,6786917,17049286,4.000336580122144
5,ClipAndMerge,10000000,120,-30,5,5039452,2331889,7371341,4.998386284576041
6,ClipAndMerge,10000000,120,-30,6,9032775,3026732,12059507,6.003555856049328
7,ClipAndMerge,10000000,120,-30,7,15322815,3820570,19143385,6.998905725130083
8,ClipAndMerge,10000000,120,-30,8,761196754,143311020,904507774,8.001327167996932
2,fastp,10000000,120,0,9,19266,2863,22129,8.881404407680836
13,fastp,10000000,120,0,24,4282141,17848,4299989,23.818777873165004
14,fastp,10000000,120,0,24,8358781,29827,8388608,24.490803260568576
15,fastp,10000000,120,0,15,14463687,472904,14936591,14.994785016671365
16,fastp,10000000,120,0,16,18082193,466177,18548370,15.997549078326303
18,fastp,10000000,120,0,18,872060,14008,886068,18.01090919389025
21,fastp,10000000,120,0,21,1071780,8527,1080307,21.027509271884806
22,fastp,10000000,120,0,22,114711,745,115456,21.902602344415172
23,fastp,10000000,120,0,23,3307108,16632,3323740,23.006825673742092
24,fastp,10000000,120,0,24,2016286,8040,2024326,24.010244043799712
25,fastp,10000000,120,0,25,6407900,20318,6428218,25.00209640570954
26,fastp,10000000,120,0,26,3073468,7746,3081214,25.99644369831628
27,fastp,10000000,120,0,27,6304350,12637,6316987,26.98865997651629
28,fastp,10000000,120,0,28,6422613,10188,6432801,28.003111803289574
29,fastp,10000000,120,0,29,10680128,13676,10693804,28.931731278026113
30,fastp,10000000,120,0,30,1453587,1479,1455066,29.929145188341238
31,fastp,10000000,120,0,31,11213954,9003,11222957,30.957200488066327
32,fastp,10000000,120,0,32,4668661,2940,4671601,32.01118412318446
33,fastp,10000000,120,0,33,24982685,12916,24995601,32.867355471457934
34,fastp,10000000,120,0,34,54881080,22327,54903407,33.90768922807307
35,fastp,10000000,120,0,35,21179478,6682,21186160,35.01145776492392
36,fastp,10000000,120,0,36,33960231,8640,33968871,35.94567370284035
37,fastp,10000000,120,0,37,49890801,10108,49900909,36.93443223599729
38,fastp,10000000,120,0,38,909609544,145636,909755180,37.956557948604875
0,fastp,10000000,120,-10,0,0,51454,51454,0.0
3,fastp,10000000,120,-10,3,2234674,2244027,4478701,3.001239917054954
4,fastp,10000000,120,-10,4,5206382,3426083,8632465,4.013369462559484
5,fastp,10000000,120,-10,5,10141775,4677563,14819338,5.008091580217627
6,fastp,10000000,120,-10,6,13802140,4586865,18389005,6.030422726630019
8,fastp,10000000,120,-10,8,739427,136635,876062,8.069728816868963
11,fastp,10000000,120,-10,11,989781,85317,1075098,11.00412477986541
12,fastp,10000000,120,-10,12,107045,7264,114309,11.96904589951906
13,fastp,10000000,120,-10,13,3134051,165546,3299597,12.995422084824817
14,fastp,10000000,120,-10,14,1930922,79853,2010775,14.010722401941123
15,fastp,10000000,120,-10,15,6180595,200028,6380623,15.037722923946315
16,fastp,10000000,120,-10,16,2985849,76877,3062726,16.003117179955034
17,fastp,10000000,120,-10,17,6155747,124330,6280077,17.033890350035676
18,fastp,10000000,120,-10,18,6294603,100876,6395479,18.02085224255412
19,fastp,10000000,120,-10,19,10486973,132447,10619420,19.040586718394795
20,fastp,10000000,120,-10,20,1429565,14308,1443873,20.03950063817072
21,fastp,10000000,120,-10,21,11062472,87990,11150462,21.028595442932843
22,fastp,10000000,120,-10,22,4607758,28548,4636306,22.10596403944762
23,fastp,10000000,120,-10,23,24683549,122557,24806106,23.062204735873753
24,fastp,10000000,120,-10,24,54288903,214548,54503451,24.048995309830197
25,fastp,10000000,120,-10,25,20983984,66224,21050208,25.022409824597027
26,fastp,10000000,120,-10,26,33644505,84561,33729066,26.008342049967688
27,fastp,10000000,120,-10,27,49466774,98141,49564915,27.033238868565928
28,fastp,10000000,120,-10,28,902087075,1418969,903506044,28.039581545222365
0,fastp,10000000,120,-20,0,0,13397753,13397753,0.0
1,fastp,10000000,120,-20,1,71526,276508,348034,0.9991397200276596
2,fastp,10000000,120,-20,2,13716,23238,36954,2.014627071041716
3,fastp,10000000,120,-20,3,533825,535131,1068956,3.0049971902660055
4,fastp,10000000,120,-20,4,393981,233816,627797,4.289450094825219
5,fastp,10000000,120,-20,6,1428814,555998,1984812,5.526461476097156
6,fastp,10000000,120,-20,7,751571,211423,962994,6.584713502480528
7,fastp,10000000,120,-20,8,1644606,348291,1992897,7.575426011645298
8,fastp,10000000,120,-20,9,1759016,280232,2039248,8.619523186979144
9,fastp,10000000,120,-20,10,3032766,373060,3405826,9.604437706609975
10,fastp,10000000,120,-20,11,427465,35292,462757,11.17676726375121
11,fastp,10000000,120,-20,12,3352159,247260,3599419,11.630785398986635
12,fastp,10000000,120,-20,13,1438618,67954,1506572,13.457748658565496
13,fastp,10000000,120,-20,14,7772486,307443,8079929,14.196429352744591
14,fastp,10000000,120,-20,15,17301656,521593,17823249,15.336551201108652
15,fastp,10000000,120,-20,15,6646390,193255,6839645,15.48902821955384
16,fastp,10000000,120,-20,17,10727786,240287,10968073,16.59400057064243
17,fastp,10000000,120,-20,18,15860786,274118,16134904,17.698288312787366
18,fastp,10000000,120,-20,19,290557570,3908491,294466061,18.770261306801316
2,leeHom,10000000,120,0,100,1,0,1,100.0
3,leeHom,10000000,120,0,3,140152,137131,277283,3.057876011201264
4,leeHom,10000000,120,0,4,75088,54729,129817,3.7511405575068824
5,leeHom,10000000,120,0,5,59350,26432,85782,5.1126614191954145
6,leeHom,10000000,120,0,6,27324,8740,36064,6.155624617316095
7,leeHom,10000000,120,0,7,9087,2307,11394,6.936286205995677
8,leeHom,10000000,120,0,8,21079,4123,25202,7.8622167242851155
9,leeHom,10000000,120,0,9,10933,1751,12684,8.599700872716049
10,leeHom,10000000,120,0,10,68804,7599,76403,10.023539671789115
11,leeHom,10000000,120,0,11,43632,3375,47007,11.43888758109275
12,leeHom,10000000,120,0,12,33251,2077,35328,12.30682555177987
13,leeHom,10000000,120,0,13,64865,3293,68158,13.159251074770847
14,leeHom,10000000,120,0,14,35049,1413,36462,14.116983248824015
15,leeHom,10000000,120,0,15,44741,1387,46128,15.218881639708478
16,leeHom,10000000,120,0,16,20054,482,20536,16.294688174245373
17,leeHom,10000000,120,0,17,39138,808,39946,16.940619368954234
18,leeHom,10000000,120,0,18,68982,1084,70066,18.104780425480424
19,leeHom,10000000,120,0,19,115346,1436,116782,19.10221468768244
20,leeHom,10000000,120,0,20,150407,1534,151941,19.958496207747245
21,leeHom,10000000,120,0,21,144503,1171,145674,20.948251504234953
22,leeHom,10000000,120,0,22,889807,5472,895279,22.138123089260734
23,leeHom,10000000,120,0,23,838525,4139,842664,23.08759014138124
24,leeHom,10000000,120,0,24,632598,2530,635128,23.997407381188278
25,leeHom,10000000,120,0,25,272906,884,273790,24.90965316753745
26,leeHom,10000000,120,0,100,725,0,725,100.0
27,leeHom,10000000,120,0,30,954,1,955,29.800033715837465
28,leeHom,10000000,120,0,30,1037,1,1038,30.16197353512439
29,leeHom,10000000,120,0,100,491,0,491,100.0
30,leeHom,10000000,120,0,31,1405,1,1406,31.47985320683805
31,leeHom,10000000,120,0,33,48389,27,48416,32.53625142184105
32,leeHom,10000000,120,0,33,130439,63,130502,33.16276618023845
33,leeHom,10000000,120,0,34,410554,181,410735,33.55883137137659
34,leeHom,10000000,120,0,34,502630,188,502818,34.27252967007101
35,leeHom,10000000,120,0,35,44764,15,44779,34.74983131676139
36,leeHom,10000000,120,0,35,673991,211,674202,35.045075812107186
37,leeHom,10000000,120,0,37,440948,88,441036,36.99991368481471
38,leeHom,10000000,120,0,39,53306,6,53312,39.48673725007031
39,leeHom,10000000,120,0,100,2497,0,2497,100.0
40,leeHom,10000000,120,0,40,58543,6,58549,39.89368231463838
41,leeHom,10000000,120,0,39,16030,2,16032,39.039577085231706
42,leeHom,10000000,120,0,42,79334,5,79339,42.00516717927411
43,leeHom,10000000,120,0,46,124701,3,124704,46.18759129392934
44,leeHom,10000000,120,0,44,360908,16,360924,43.53295779206885
45,leeHom,10000000,120,0,43,391975,19,391994,43.14525818652236
46,leeHom,10000000,120,0,47,543341,12,543353,46.55900823213792
47,leeHom,10000000,120,0,46,473196,13,473209,45.61109643609257
48,leeHom,10000000,120,0,48,657595,11,657606,47.76573081896585
49,leeHom,10000000,120,0,50,638536,7,638543,49.60092108310196
50,leeHom,10000000,120,0,49,793510,10,793520,48.995578772536604
51,leeHom,10000000,120,0,53,1083606,5,1083611,53.35903400676877
52,leeHom,10000000,120,0,50,2352079,21,2352100,50.492364871790976
53,leeHom,10000000,120,0,52,2356334,14,2356348,52.26111394460135
54,leeHom,10000000,120,0,54,3007615,13,3007628,53.64280767000395
55,leeHom,10000000,120,0,57,2277378,5,2277383,56.584660701083145
56,leeHom,10000000,120,0,55,7703798,22,7703820,55.442834461083955
57,leeHom,10000000,120,0,57,17632695,35,17632730,57.02251513107772
58,leeHom,10000000,120,0,58,26471597,45,26471642,57.69568367058387
59,leeHom,10000000,120,0,58,32450981,46,32451027,58.48470614088868
60,leeHom,10000000,120,0,75,1094133352,35,1094133387,74.95002226190834
2,leeHom,10000000,120,-10,2,53052,72089,125141,2.3953061995217
3,leeHom,10000000,120,-10,3,1424487,1433962,2858449,2.9959280532681243
4,leeHom,10000000,120,-10,4,558188,390728,948916,3.8535323512402417
5,leeHom,10000000,120,-10,5,503036,215890,718926,5.224516638507839
6,leeHom,10000000,120,-10,6,267573,85367,352940,6.164108618088296
7,leeHom,10000000,120,-10,7,106139,26275,132414,7.023911803528927
8,leeHom,10000000,120,-10,8,208491,41496,249987,7.799111897862636
9,leeHom,10000000,120,-10,9,157217,24221,181438,8.745361803191186
10,leeHom,10000000,120,-10,10,746730,84067,830797,9.948693700945817
11,leeHom,10000000,120,-10,11,391249,32472,423721,11.155709502565799
12,leeHom,10000000,120,-10,12,571133,39512,610645,11.890597922653773
13,leeHom,10000000,120,-10,13,922403,47843,970246,13.070634566525229
14,leeHom,10000000,120,-10,14,621879,25617,647496,14.027088215684921
15,leeHom,10000000,120,-10,15,500620,16136,516756,15.054896426718082
16,leeHom,10000000,120,-10,16,172321,4491,176812,15.95168681615068
17,leeHom,10000000,120,-10,17,375687,7497,383184,17.08519855800526
18,leeHom,10000000,120,-10,18,401422,6247,407669,18.146361821045943
19,leeHom,10000000,120,-10,19,680039,8959,688998,18.85958424663359
20,leeHom,10000000,120,-10,20,1573886,16691,1590577,19.790723410549646
21,leeHom,10000000,120,-10,21,1515368,12410,1527778,20.902884703983283
22,leeHom,10000000,120,-10,22,9789667,57925,9847592,22.30464004384558
23,leeHom,10000000,120,-10,23,8543083,38538,8581621,23.476801579756454
24,leeHom,10000000,120,-10,24,701754,2922,704676,23.823092688601662
25,leeHom,10000000,120,-10,25,6621658,22873,6644531,24.63141201984214
26,leeHom,10000000,120,-10,26,3212775,8533,3221308,25.76930505515979
27,leeHom,10000000,120,-10,28,591998,1038,593036,27.56883704315218
28,leeHom,10000000,120,-10,28,786048,1288,787336,27.862442464696755
29,leeHom,10000000,120,-10,29,918420,1231,919651,28.733649944902176
30,leeHom,10000000,120,-10,30,882269,930,883199,29.775756201025565
31,leeHom,10000000,120,-10,31,1590176,1282,1591458,30.939071565056544
32,leeHom,10000000,120,-10,32,2115949,1236,2117185,32.33740337653386
33,leeHom,10000000,120,-10,33,4159718,2129,4161847,32.91110448969458
34,leeHom,10000000,120,-10,34,1179562,487,1180049,33.84371079979446
35,leeHom,10000000,120,-10,35,10870527,3765,10874292,34.60636010101207
36,leeHom,10000000,120,-10,36,18320978,4525,18325503,36.07437320488252
37,leeHom,10000000,120,-10,37,1583434,344,1583778,36.63135863386582
38,leeHom,10000000,120,-10,38,24877679,4385,24882064,37.539168051105925
39,leeHom,10000000,120,-10,39,687653,78,687731,39.45323998248175
40,leeHom,10000000,120,-10,39,1626899,195,1627094,39.213780322332525
41,leeHom,10000000,120,-10,42,763675,46,763721,42.20176900859914
42,leeHom,10000000,120,-10,42,1186536,73,1186609,42.10984777860006
43,leeHom,10000000,120,-10,43,1815754,96,1815850,42.76808737322337
44,leeHom,10000000,120,-10,44,1312586,58,1312644,43.5471896421027
45,leeHom,10000000,120,-10,45,1532079,52,1532131,44.69292556221088
46,leeHom,10000000,120,-10,46,5531451,142,5531593,45.90561873989021
47,leeHom,10000000,120,-10,47,5941256,133,5941389,46.50036346862021
48,leeHom,10000000,120,-10,48,12641305,217,12641522,47.653396309529725
49,leeHom,10000000,120,-10,49,6826404,95,6826499,48.56474425654313
50,leeHom,10000000,120,-10,50,13426652,145,13426797,49.666044206250135
51,leeHom,10000000,120,-10,51,12417166,98,12417264,51.027998389404026
52,leeHom,10000000,120,-10,51,19917324,149,19917473,51.26047968698886
53,leeHom,10000000,120,-10,53,7246248,34,7246282,53.286363142103326
54,leeHom,10000000,120,-10,55,21835679,77,21835756,54.52677507537571
55,leeHom,10000000,120,-10,54,12501163,50,12501213,53.9798215056387
56,leeHom,10000000,120,-10,57,45816236,98,45816334,56.69794260420902
57,leeHom,10000000,120,-10,57,76679463,162,76679625,56.75164965761087
58,leeHom,10000000,120,-10,58,32956842,57,32956899,57.620714853821426
59,leeHom,10000000,120,-10,58,51727091,74,51727165,58.44486957042782
60,leeHom,10000000,120,-10,61,754356881,632,754357513,60.76860141758039
2,leeHom,10000000,120,-20,0,32112,1626928,1659040,0.08488523553983345
3,leeHom,10000000,120,-20,3,11398270,12170316,23568586,2.8703167300679784
4,leeHom,10000000,120,-20,4,3648219,2476100,6124319,3.932896237374278
5,leeHom,10000000,120,-20,5,4843726,2039625,6883351,5.282495893825553
6,leeHom,10000000,120,-20,6,2847045,849491,3696536,6.386361580198269
7,leeHom,10000000,120,-20,7,1329876,334032,1663908,6.973412359465407
8,leeHom,10000000,120,-20,8,2537787,438692,2976479,8.31543108143337
9,leeHom,10000000,120,-20,8,835213,159217,994430,7.9558478104999155
10,leeHom,10000000,120,-20,10,3524736,399791,3924527,9.919543081351502
11,leeHom,10000000,120,-20,10,2659118,267834,2926952,10.385498929761862
12,leeHom,10000000,120,-20,13,5697366,316471,6013837,12.788177333819968
13,leeHom,10000000,120,-20,14,6893712,267400,7161112,14.278190632318992
14,leeHom,10000000,120,-20,14,5469240,218486,5687726,14.155150527961759
15,leeHom,10000000,120,-20,15,4617301,160008,4777309,14.750416358539361
16,leeHom,10000000,120,-20,15,6363131,186012,6549143,15.466435110037573
17,leeHom,10000000,120,-20,20,80407798,888112,81295910,19.61600958568343
18,leeHom,10000000,120,-20,11,324268,29978,354246,10.72502299807163
19,leeHom,10000000,120,-20,13,689629,38113,727742,12.809043051088697
20,leeHom,10000000,120,-20,4,691187,433123,1124310,4.14274826894718
21,leeHom,10000000,120,-20,21,390502,3156,393658,20.959820871534
22,leeHom,10000000,120,-20,22,687799,4305,692104,22.06198203453839
23,leeHom,10000000,120,-20,23,2679022,14176,2693198,22.78714578740944
24,leeHom,10000000,120,-20,24,835019,3457,838476,23.84791256610508
25,leeHom,10000000,120,-20,25,3668196,12528,3680724,24.68051508274511
26,leeHom,10000000,120,-20,26,8937134,21970,8959104,26.10434521121807
27,leeHom,10000000,120,-20,27,4854578,8950,4863528,27.35128385195885
28,leeHom,10000000,120,-20,28,1815009,2983,1817992,27.849387144328517
29,leeHom,10000000,120,-20,29,10989343,14294,11003637,28.863824772079276
30,leeHom,10000000,120,-20,30,10565353,10403,10575756,30.071528238848394
31,leeHom,10000000,120,-20,31,17511998,13376,17525374,31.17341034697997
32,leeHom,10000000,120,-20,32,6629352,3921,6633273,32.283310292562334
33,leeHom,10000000,120,-20,33,20043591,9092,20052683,33.43513061331707
34,leeHom,10000000,120,-20,34,11674306,4179,11678485,34.463141361177584
35,leeHom,10000000,120,-20,35,38581711,11248,38592959,35.35432770406038
36,leeHom,10000000,120,-20,36,4515965,1273,4517238,35.50044569210976
37,leeHom,10000000,120,-20,36,72807925,16310,72824235,36.49821970130714
38,leeHom,10000000,120,-20,38,31537691,5593,31543284,37.51262086812172
39,leeHom,10000000,120,-20,39,49777399,6897,49784296,38.584321441581395
40,leeHom,10000000,120,-20,40,70888835,7640,70896475,39.67531283855526
41,leeHom,10000000,120,-20,41,661171285,56813,661228098,40.65903577329399
2,leeHom,10000000,120,-30,1,802757,4105125,4907882,0.7756772664454232
3,leeHom,10000000,120,-30,3,61146868,65909136,127056004,2.850495738194774
4,leeHom,10000000,120,-30,4,8324444,5721939,14046383,3.900212824638327
5,leeHom,10000000,120,-30,5,20918616,8783876,29702492,5.291066912695759
6,leeHom,10000000,120,-30,6,13044466,4299712,17344178,6.057143549878006
7,leeHom,10000000,120,-30,9,73228028,9939084,83167112,9.226052597046856
8,leeHom,10000000,120,-30,1,98051,265389,363440,1.3654980579927005
9,leeHom,10000000,120,-30,5,803113,406592,1209705,4.735206463756045
10,leeHom,10000000,120,-30,2,3612259,4670483,8282742,2.4881233804672744
11,leeHom,10000000,120,-30,11,441671,36875,478546,11.131916614776793
12,leeHom,10000000,120,-30,12,9979378,637219,10616597,12.216966153891587
13,leeHom,10000000,120,-30,13,1238227,66525,1304752,12.925430880165054
14,leeHom,10000000,120,-30,14,20730624,858275,21588899,14.0060403206573
15,leeHom,10000000,120,-30,15,9236914,268676,9505590,15.487502041730137
16,leeHom,10000000,120,-30,16,843455,23435,866890,15.680990353249298
17,leeHom,10000000,120,-30,17,17271831,362185,17634016,16.8742077059326
18,leeHom,10000000,120,-30,18,26179443,409490,26588933,18.12457609185331
19,leeHom,10000000,120,-30,19,255938456,3027863,258966319,19.321070626847114
0,SeqPrep,10000000,120,0,3,118473,118727,237200,3.005651905262052
1,SeqPrep,10000000,120,0,4,49337,39622,88959,3.512534986614082
2,SeqPrep,10000000,120,0,4,32235,20512,52747,4.10189756216392
3,SeqPrep,10000000,120,0,5,23141,11783,34924,4.71868101866569
4,SeqPrep,10000000,120,0,5,32049,12844,44893,5.434783314501993
5,SeqPrep,10000000,120,0,6,25500,8152,33652,6.1574670924520305
6,SeqPrep,10000000,120,0,7,8433,2148,10581,6.92492437359634
7,SeqPrep,10000000,120,0,8,19561,3847,23408,7.8424212247442
8,SeqPrep,10000000,120,0,9,10151,1625,11776,8.601444316785305
9,SeqPrep,10000000,120,0,10,33571,4008,37579,9.720175062193071
10,SeqPrep,10000000,120,0,10,30463,2998,33461,10.477072874324735
11,SeqPrep,10000000,120,0,11,41094,3176,44270,11.442290282237892
12,SeqPrep,10000000,120,0,12,31404,1952,33356,12.3269415183397
13,SeqPrep,10000000,120,0,13,60724,3089,63813,13.150912540112623
14,SeqPrep,10000000,120,0,14,33293,1322,34615,14.180328807978338
15,SeqPrep,10000000,120,0,15,40017,1245,41262,15.20380923293911
16,SeqPrep,10000000,120,0,16,18741,451,19192,16.289436930818137
17,SeqPrep,10000000,120,0,17,36385,744,37129,16.981403169302048
18,SeqPrep,10000000,120,0,18,64417,1014,65431,18.09745602793987
19,SeqPrep,10000000,120,0,19,107693,1341,109034,19.101331669689095
20,SeqPrep,10000000,120,0,20,139802,1433,141235,19.936961438771313
21,SeqPrep,10000000,120,0,21,134927,1083,136010,20.98942383988719
22,SeqPrep,10000000,120,0,22,828309,5087,833396,22.14389674038145
23,SeqPrep,10000000,120,0,23,781079,3863,784942,23.079128594150205
24,SeqPrep,10000000,120,0,24,588547,2349,590896,24.006280333073114
25,SeqPrep,10000000,120,0,25,254716,824,255540,24.915316787602766
26,SeqPrep,10000000,120,0,29,734,1,735,28.66287339084195
27,SeqPrep,10000000,120,0,33,48026,27,48053,32.503567421593054
28,SeqPrep,10000000,120,0,33,126729,62,126791,33.10696737635333
29,SeqPrep,10000000,120,0,33,401274,180,401454,33.48363284385186
30,SeqPrep,10000000,120,0,34,493314,184,493498,34.284675739338624
31,SeqPrep,10000000,120,0,35,699620,223,699843,34.966957599929856
32,SeqPrep,10000000,120,0,37,353561,76,353637,36.67744105392768
33,SeqPrep,10000000,120,0,39,53333,6,53339,39.48893618890106
34,SeqPrep,10000000,120,0,100,3208,0,3208,100.0
35,SeqPrep,10000000,120,0,37,14978,3,14981,36.984195492971054
36,SeqPrep,10000000,120,0,38,100671,15,100686,38.26877828723003
37,SeqPrep,10000000,120,0,42,79241,5,79246,42.00007345774344
38,SeqPrep,10000000,120,0,46,124437,3,124440,46.178387477170034
39,SeqPrep,10000000,120,0,43,357711,16,357727,43.494317377795504
40,SeqPrep,10000000,120,0,43,433702,23,433725,42.754866196777016
41,SeqPrep,10000000,120,0,46,534625,12,534637,46.48877765125207
42,SeqPrep,10000000,120,0,46,465842,13,465855,45.54307408805559
43,SeqPrep,10000000,120,0,48,647196,11,647207,47.69650520672401
44,SeqPrep,10000000,120,0,50,628361,7,628368,49.53116020221785
45,SeqPrep,10000000,120,0,49,780787,10,780797,48.92538136003476
46,SeqPrep,10000000,120,0,53,1066364,5,1066369,53.289375070466896
47,SeqPrep,10000000,120,0,51,2315280,19,2315299,50.8585348324131
48,SeqPrep,10000000,120,0,53,2319133,13,2319146,52.51384737857001
49,SeqPrep,10000000,120,0,54,2960775,13,2960788,53.5746395959907
50,SeqPrep,10000000,120,0,57,2241660,5,2241665,56.516007067231186
51,SeqPrep,10000000,120,0,55,7582295,22,7582317,55.3737925654503
52,SeqPrep,10000000,120,0,57,17355410,35,17355445,56.95367709270337
53,SeqPrep,10000000,120,0,58,26054032,45,26054077,57.62663178545816
54,SeqPrep,10000000,120,0,58,31939332,46,31939378,58.41568622581815
55,SeqPrep,10000000,120,0,54,718779,3,718782,53.794759380932405
56,SeqPrep,10000000,120,0,61,2303193,2,2303195,60.61300713398313
57,SeqPrep,10000000,120,0,58,1193920,2,1193922,57.75945959206332
58,SeqPrep,10000000,120,0,100,916623,0,916623,100.0
59,SeqPrep,10000000,120,0,63,2051046,1,2051047,63.119756123950744
60,SeqPrep,10000000,120,0,76,1069733272,27,1069733299,75.97911750713027
0,SeqPrep,10000000,120,-10,3,1079979,1112796,2192775,2.9457851524026686
1,SeqPrep,10000000,120,-10,3,410530,370144,780674,3.2409900171927597
2,SeqPrep,10000000,120,-10,4,278366,189036,467402,3.931460473397018
3,SeqPrep,10000000,120,-10,5,206666,107916,314582,4.646480297342629
4,SeqPrep,10000000,120,-10,5,300488,119439,419927,5.4602764070743435
5,SeqPrep,10000000,120,-10,6,238156,76115,314271,6.158340557387253
6,SeqPrep,10000000,120,-10,7,82217,20663,102880,6.971375798844333
7,SeqPrep,10000000,120,-10,8,201573,40106,241679,7.800295658028529
8,SeqPrep,10000000,120,-10,9,146166,22453,168619,8.756321330173273
9,SeqPrep,10000000,120,-10,10,487701,57329,545030,9.780460413725443
10,SeqPrep,10000000,120,-10,11,530924,45829,576753,10.99849481260011
11,SeqPrep,10000000,120,-10,12,759494,49226,808720,12.156036361751713
12,SeqPrep,10000000,120,-10,13,500272,25781,526053,13.09729742790247
13,SeqPrep,10000000,120,-10,13,614010,28864,642874,13.477693459163447
14,SeqPrep,10000000,120,-10,14,313604,11613,325217,14.472288132611002
15,SeqPrep,10000000,120,-10,15,402860,11951,414811,15.404460181365494
16,SeqPrep,10000000,120,-10,17,199896,4367,204263,16.700065141575365
17,SeqPrep,10000000,120,-10,18,422004,7241,429245,17.72906697563672
18,SeqPrep,10000000,120,-10,19,727977,10024,738001,18.67015892311457
19,SeqPrep,10000000,120,-10,20,1347479,14132,1361611,19.838494225117852
20,SeqPrep,10000000,120,-10,21,1708425,14526,1722951,20.741268866463237
21,SeqPrep,10000000,120,-10,22,1767724,11252,1778976,21.989403656037613
22,SeqPrep,10000000,120,-10,22,8916891,50855,8967746,22.46349640273968
23,SeqPrep,10000000,120,-10,24,8563134,37320,8600454,23.62579742272664
24,SeqPrep,10000000,120,-10,25,6545197,22062,6567259,24.73739264107685
25,SeqPrep,10000000,120,-10,26,3168609,7915,3176524,26.03501221766213
26,SeqPrep,10000000,120,-10,28,637945,962,638907,28.222625743424402
27,SeqPrep,10000000,120,-10,29,1393874,1594,1395468,29.422315649091185
28,SeqPrep,10000000,120,-10,31,1652059,1412,1653471,30.68561885569666
29,SeqPrep,10000000,120,-10,32,2053009,1212,2054221,32.29144544804623
30,SeqPrep,10000000,120,-10,33,1547108,738,1547846,33.21671387368006
31,SeqPrep,10000000,120,-10,33,4382841,2086,4384927,33.22648063563411
32,SeqPrep,10000000,120,-10,35,11054788,3724,11058512,34.7268702123582
33,SeqPrep,10000000,120,-10,36,18269356,4432,18273788,36.15228830496823
34,SeqPrep,10000000,120,-10,38,24242700,4259,24246959,37.55349638025977
35,SeqPrep,10000000,120,-10,40,660379,69,660448,39.80989538628767
36,SeqPrep,10000000,120,-10,40,2017582,205,2017787,39.931214586216846
37,SeqPrep,10000000,120,-10,42,1125784,68,1125852,42.18972390945999
38,SeqPrep,10000000,120,-10,42,872479,51,872530,42.332101920381184
39,SeqPrep,10000000,120,-10,43,1918133,93,1918226,43.14416824651289
40,SeqPrep,10000000,120,-10,45,1793340,61,1793401,44.683475725747314
41,SeqPrep,10000000,120,-10,46,5367712,138,5367850,45.89921284939565
42,SeqPrep,10000000,120,-10,46,5765938,132,5766070,46.40305979206589
43,SeqPrep,10000000,120,-10,48,12266446,213,12266659,47.60346689080982
44,SeqPrep,10000000,120,-10,49,6624647,91,6624738,48.62127314830506
45,SeqPrep,10000000,120,-10,50,13028743,139,13028882,49.718923505266275
46,SeqPrep,10000000,120,-10,51,12049454,98,12049552,50.89744824534179
47,SeqPrep,10000000,120,-10,51,19327840,143,19327983,51.30850497490802
48,SeqPrep,10000000,120,-10,53,7032513,34,7032547,53.15633726286621
49,SeqPrep,10000000,120,-10,55,21189663,74,21189737,54.5689384669395
50,SeqPrep,10000000,120,-10,54,12132858,48,12132906,54.0272359552824
51,SeqPrep,10000000,120,-10,57,44464925,94,44465019,56.74890628627007
52,SeqPrep,10000000,120,-10,57,74419950,157,74420107,56.757906376981595
53,SeqPrep,10000000,120,-10,57,31978756,57,31978813,57.48987483752819
54,SeqPrep,10000000,120,-10,58,50194234,71,50194305,58.493960965658104
55,SeqPrep,10000000,120,-10,61,71142157,59,71142216,60.81275377202879
56,SeqPrep,10000000,120,-10,61,660857901,555,660858456,60.75815468252902
0,SeqPrep,10000000,120,-20,2,349456,517386,866842,2.241252725579887
1,SeqPrep,10000000,120,-20,3,62008,53672,115680,3.335105010826427
2,SeqPrep,10000000,120,-20,4,58108,37715,95823,4.049556514546173
3,SeqPrep,10000000,120,-20,4,57409,33949,91358,4.299195972264471
4,SeqPrep,10000000,120,-20,5,118403,50298,168701,5.2556694039883824
5,SeqPrep,10000000,120,-20,6,109747,40752,150499,5.6738468662311465
6,SeqPrep,10000000,120,-20,7,62403,17623,80026,6.571512685435865
7,SeqPrep,10000000,120,-20,7,132270,29178,161448,7.4297714944258715
8,SeqPrep,10000000,120,-20,8,73437,13398,86835,8.11654835167403
9,SeqPrep,10000000,120,-20,9,205932,27722,233654,9.257486610670137
10,SeqPrep,10000000,120,-20,11,142517,13766,156283,10.551039741083915
11,SeqPrep,10000000,120,-20,11,230890,18629,249519,11.26914078521693
12,SeqPrep,10000000,120,-20,12,135065,8331,143396,12.358399024814116
13,SeqPrep,10000000,120,-20,13,412945,20986,433931,13.15491008678115
14,SeqPrep,10000000,120,-20,14,427269,18928,446197,13.724219187002129
15,SeqPrep,10000000,120,-20,15,246935,7901,254836,15.085787178204539
16,SeqPrep,10000000,120,-20,16,226684,6061,232745,15.843360759087453
17,SeqPrep,10000000,120,-20,17,363371,7545,370916,16.916163235438738
18,SeqPrep,10000000,120,-20,17,4820498,90254,4910752,17.35681543532834
19,SeqPrep,10000000,120,-20,20,81030,749,81779,20.381599779644706
20,SeqPrep,10000000,120,-20,23,109098,595,109693,22.65661948460827
21,SeqPrep,10000000,120,-20,23,293096,1379,294475,23.294841642786377
22,SeqPrep,10000000,120,-20,25,362392,1173,363565,24.912840553978178
23,SeqPrep,10000000,120,-20,26,805128,1933,807061,26.20674507164647
24,SeqPrep,10000000,120,-20,28,480519,820,481339,27.6863719898532
25,SeqPrep,10000000,120,-20,29,984001,1299,985300,28.799593317166995
26,SeqPrep,10000000,120,-20,30,944318,885,945203,30.2858182068123
27,SeqPrep,10000000,120,-20,31,1563587,1223,1564810,31.070351557976686
28,SeqPrep,10000000,120,-20,32,595981,346,596327,32.364083746239814
29,SeqPrep,10000000,120,-20,34,1793421,801,1794222,33.50243661425451
30,SeqPrep,10000000,120,-20,35,1052766,357,1053123,34.69810881665553
31,SeqPrep,10000000,120,-20,35,3873834,1149,3874983,35.279497728579436
32,SeqPrep,10000000,120,-20,37,6539146,1453,6540599,36.53351909329325
33,SeqPrep,10000000,120,-20,38,2807283,499,2807782,37.50262839931118
34,SeqPrep,10000000,120,-20,39,4432116,582,4432698,38.81745159146333
35,SeqPrep,10000000,120,-20,39,6315016,732,6315748,39.359137121599424
36,SeqPrep,10000000,120,-20,41,58861475,5177,58866652,40.55791171335278
0,seqtk_adna_trim,10000000,120,0,3,1242,1150,2392,3.180633349627615
1,seqtk_adna_trim,10000000,120,0,3,332,299,631,3.2435817091970467
2,seqtk_adna_trim,10000000,120,0,4,315,196,511,4.161648287782366
3,seqtk_adna_trim,10000000,120,0,5,336,155,491,5.007497939526769
4,seqtk_adna_trim,10000000,120,0,5,1085,458,1543,5.275004480592791
5,seqtk_adna_trim,10000000,120,0,6,777,264,1041,5.958468026407051
6,seqtk_adna_trim,10000000,120,0,7,301,69,370,7.293526333297397
7,seqtk_adna_trim,10000000,120,0,8,345,71,416,7.678349819076674
8,seqtk_adna_trim,10000000,120,0,9,186,27,213,8.970158392797504
9,seqtk_adna_trim,10000000,120,0,9,332,51,383,8.756285978706863
10,seqtk_adna_trim,10000000,120,0,10,455,54,509,9.743240225137903
11,seqtk_adna_trim,10000000,120,0,12,525,36,561,11.926603604888742
12,seqtk_adna_trim,10000000,120,0,14,502,23,525,13.58431467388364
13,seqtk_adna_trim,10000000,120,0,12,491,32,523,12.133517105473683
14,seqtk_adna_trim,10000000,120,0,17,319,6,325,17.337321105952306
15,seqtk_adna_trim,10000000,120,0,16,968,24,992,16.163004304425726
16,seqtk_adna_trim,10000000,120,0,25,1437,5,1442,24.599952560473916
17,seqtk_adna_trim,10000000,120,0,15,351,12,363,14.807253789884879
18,seqtk_adna_trim,10000000,120,0,21,450,4,454,20.549958615291413
19,seqtk_adna_trim,10000000,120,0,22,730,5,735,21.67317334748176
20,seqtk_adna_trim,10000000,120,0,25,916,3,919,24.86194256666449
21,seqtk_adna_trim,10000000,120,0,24,689,3,692,23.629848397370953
22,seqtk_adna_trim,10000000,120,0,24,1863,8,1871,23.689838005080667
23,seqtk_adna_trim,10000000,120,0,24,2151,9,2160,23.80211241711606
24,seqtk_adna_trim,10000000,120,0,26,1542,4,1546,25.87149498254344
25,seqtk_adna_trim,10000000,120,0,26,1781,4,1785,26.495782291202495
26,seqtk_adna_trim,10000000,120,0,100,359,0,359,100.0
27,seqtk_adna_trim,10000000,120,0,100,738,0,738,100.0
28,seqtk_adna_trim,10000000,120,0,100,760,0,760,100.0
29,seqtk_adna_trim,10000000,120,0,100,1380,0,1380,100.0
30,seqtk_adna_trim,10000000,120,0,100,253,0,253,100.0
31,seqtk_adna_trim,10000000,120,0,100,1693,0,1693,100.0
32,seqtk_adna_trim,10000000,120,0,100,902,0,902,100.0
33,seqtk_adna_trim,10000000,120,0,100,5412,0,5412,100.0
34,seqtk_adna_trim,10000000,120,0,100,12789,0,12789,100.0
35,seqtk_adna_trim,10000000,120,0,100,6807,0,6807,100.0
36,seqtk_adna_trim,10000000,120,0,100,11498,0,11498,100.0
37,seqtk_adna_trim,10000000,120,0,100,17805,0,17805,100.0
38,seqtk_adna_trim,10000000,120,0,100,959731,0,959731,100.0
0,seqtk_adna_trim,10000000,120,-10,3,140526,142630,283156,2.9781488643713288
1,seqtk_adna_trim,10000000,120,-10,3,41142,35364,76506,3.3513411423266666
2,seqtk_adna_trim,10000000,120,-10,4,33750,21714,55464,4.072713536988724
3,seqtk_adna_trim,10000000,120,-10,5,30491,15801,46292,4.668213713738521
4,seqtk_adna_trim,10000000,120,-10,5,91679,36193,127872,5.481508750572543
5,seqtk_adna_trim,10000000,120,-10,7,70099,20181,90280,6.506488680032598
6,seqtk_adna_trim,10000000,120,-10,10,54774,6689,61463,9.632525583349311
7,seqtk_adna_trim,10000000,120,-10,8,26435,5242,31677,7.812470279880877
8,seqtk_adna_trim,10000000,120,-10,9,14155,1869,16024,9.331616349066877
9,seqtk_adna_trim,10000000,120,-10,9,19013,2419,21432,9.474268322382729
10,seqtk_adna_trim,10000000,120,-10,10,18804,1861,20665,10.4548903648696
11,seqtk_adna_trim,10000000,120,-10,12,26984,1910,28894,11.79774301203502
12,seqtk_adna_trim,10000000,120,-10,13,20305,1145,21450,12.726218098448363
13,seqtk_adna_trim,10000000,120,-10,14,42418,1753,44171,14.013553153938425
14,seqtk_adna_trim,10000000,120,-10,16,25614,735,26349,15.544767983875964
15,seqtk_adna_trim,10000000,120,-10,18,50998,866,51864,17.773481165775006
16,seqtk_adna_trim,10000000,120,-10,19,25488,330,25818,18.934086565883117
17,seqtk_adna_trim,10000000,120,-10,20,55140,535,55675,20.17306443684847
18,seqtk_adna_trim,10000000,120,-10,21,79615,707,80322,20.55415099975034
19,seqtk_adna_trim,10000000,120,-10,22,143426,947,144373,21.831360019906597
20,seqtk_adna_trim,10000000,120,-10,21,117325,956,118281,20.92457095311545
21,seqtk_adna_trim,10000000,120,-10,23,170361,775,171136,23.440396744035425
22,seqtk_adna_trim,10000000,120,-10,23,509201,2812,512013,22.60265671496385
23,seqtk_adna_trim,10000000,120,-10,25,704338,2118,706456,25.231591622145686
24,seqtk_adna_trim,10000000,120,-10,29,940762,1295,942057,28.618074125460403
25,seqtk_adna_trim,10000000,120,-10,30,523355,490,523845,30.29006722980606
26,seqtk_adna_trim,10000000,120,-10,41,561055,43,561098,41.155702651101265
27,seqtk_adna_trim,10000000,120,-10,43,899848,41,899889,43.41405086430165
28,seqtk_adna_trim,10000000,120,-10,49,50392690,708,50393398,48.523403858990704
0,seqtk_adna_trim,10000000,120,-20,3,3336820,4095713,7432533,2.588073295228735
1,seqtk_adna_trim,10000000,120,-20,3,580441,485268,1065709,3.4165697984229193
2,seqtk_adna_trim,10000000,120,-20,4,527074,339025,866099,4.073358125243728
3,seqtk_adna_trim,10000000,120,-20,5,490979,266797,757776,4.533599044974539
4,seqtk_adna_trim,10000000,120,-20,5,1170707,477266,1647973,5.381895953208103
5,seqtk_adna_trim,10000000,120,-20,6,956440,317656,1274096,6.03245089395206
6,seqtk_adna_trim,10000000,120,-20,7,372340,95739,468079,6.892302703447289
7,seqtk_adna_trim,10000000,120,-20,8,736984,146920,883904,7.793241795770792
8,seqtk_adna_trim,10000000,120,-20,9,448094,66325,514419,8.896397421692026
9,seqtk_adna_trim,10000000,120,-20,10,1164373,133450,1297823,9.8789688832779
10,seqtk_adna_trim,10000000,120,-20,11,765756,71003,836759,10.71323693430595
11,seqtk_adna_trim,10000000,120,-20,12,1396382,92085,1488467,12.085503181444997
12,seqtk_adna_trim,10000000,120,-20,13,829367,43172,872539,13.055826793988023
13,seqtk_adna_trim,10000000,120,-20,15,2950921,104926,3055847,14.642484892546124
14,seqtk_adna_trim,10000000,120,-20,17,4555860,92685,4648545,17.003075852103755
15,seqtk_adna_trim,10000000,120,-20,19,2786406,37412,2823818,18.778257765708144
16,seqtk_adna_trim,10000000,120,-20,21,3517469,25760,3543229,21.38453363140868
17,seqtk_adna_trim,10000000,120,-20,23,5801701,32391,5834092,22.555489173011736
18,seqtk_adna_trim,10000000,120,-20,28,300369731,437802,300807533,28.37010966701707
0,seqtk_adna_trim,10000000,120,-30,3,10365,12831,23196,2.571525950997043
1,seqtk_adna_trim,10000000,120,-30,3,1722,1700,3422,3.038310838268075
2,seqtk_adna_trim,10000000,120,-30,4,1502,1122,2624,3.6897097378348005
3,seqtk_adna_trim,10000000,120,-30,4,1549,1114,2663,3.7848597560123114
4,seqtk_adna_trim,10000000,120,-30,5,4040,1863,5903,5.008599283249521
5,seqtk_adna_trim,10000000,120,-30,6,2718,809,3527,6.3945693805521735
6,seqtk_adna_trim,10000000,120,-30,7,1703,403,2106,7.181533207083584
7,seqtk_adna_trim,10000000,120,-30,9,3421,529,3950,8.731414235912744
8,seqtk_adna_trim,10000000,120,-30,14,154980,6069,161049,14.23840895013084
