predicted_phred,program,nfrags,fraglen,qual_shift,observed_phred,n_matches,n_mismatches,n_total,observed_phred_unrounded
0,SeqPrep,10000000,120,0,3,118473,118727,237200,3.005651905262052
1,SeqPrep,10000000,120,0,4,49337,39622,88959,3.512534986614082
2,SeqPrep,10000000,120,0,4,32235,20512,52747,4.10189756216392
3,SeqPrep,10000000,120,0,5,23141,11783,34924,4.71868101866569
4,SeqPrep,10000000,120,0,5,32049,12844,44893,5.434783314501993
5,SeqPrep,10000000,120,0,6,25500,8152,33652,6.1574670924520305
6,SeqPrep,10000000,120,0,7,8433,2148,10581,6.92492437359634
7,SeqPrep,10000000,120,0,8,19561,3847,23408,7.8424212247442
8,SeqPrep,10000000,120,0,9,10151,1625,11776,8.601444316785305
9,SeqPrep,10000000,120,0,10,33571,4008,37579,9.720175062193071
10,SeqPrep,10000000,120,0,10,30463,2998,33461,10.477072874324735
11,SeqPrep,10000000,120,0,11,41094,3176,44270,11.442290282237892
12,SeqPrep,10000000,120,0,12,31404,1952,33356,12.3269415183397
13,SeqPrep,10000000,120,0,13,60724,3089,63813,13.150912540112623
14,SeqPrep,10000000,120,0,14,33293,1322,34615,14.180328807978338
15,SeqPrep,10000000,120,0,15,40017,1245,41262,15.20380923293911
16,SeqPrep,10000000,120,0,16,18741,451,19192,16.289436930818137
17,SeqPrep,10000000,120,0,17,36385,744,37129,16.981403169302048
18,SeqPrep,10000000,120,0,18,64417,1014,65431,18.09745602793987
19,SeqPrep,10000000,120,0,19,107693,1341,109034,19.101331669689095
20,SeqPrep,10000000,120,0,20,139802,1433,141235,19.936961438771313
21,SeqPrep,10000000,120,0,21,134927,1083,136010,20.98942383988719
22,SeqPrep,10000000,120,0,22,828309,5087,833396,22.14389674038145
23,SeqPrep,10000000,120,0,23,781079,3863,784942,23.079128594150205
24,SeqPrep,10000000,120,0,24,588547,2349,590896,24.006280333073114
25,SeqPrep,10000000,120,0,25,254716,824,255540,24.915316787602766
26,SeqPrep,10000000,120,0,29,734,1,735,28.66287339084195
27,SeqPrep,10000000,120,0,33,48026,27,48053,32.503567421593054
28,SeqPrep,10000000,120,0,33,126729,62,126791,33.10696737635333
29,SeqPrep,10000000,120,0,33,401274,180,401454,33.48363284385186
30,SeqPrep,10000000,120,0,34,493314,184,493498,34.284675739338624
31,SeqPrep,10000000,120,0,35,699620,223,699843,34.966957599929856
32,SeqPrep,10000000,120,0,37,353561,76,353637,36.67744105392768
33,SeqPrep,10000000,120,0,39,53333,6,53339,39.48893618890106
34,SeqPrep,10000000,120,0,100,3208,0,3208,100.0
35,SeqPrep,10000000,120,0,37,14978,3,14981,36.984195492971054
36,SeqPrep,10000000,120,0,38,100671,15,100686,38.26877828723003
37,SeqPrep,10000000,120,0,42,79241,5,79246,42.00007345774344
38,SeqPrep,10000000,120,0,46,124437,3,124440,46.178387477170034
39,SeqPrep,10000000,120,0,43,357711,16,357727,43.494317377795504
40,SeqPrep,10000000,120,0,43,433702,23,433725,42.754866196777016
41,SeqPrep,10000000,120,0,46,534625,12,534637,46.48877765125207
42,SeqPrep,10000000,120,0,46,465842,13,465855,45.54307408805559
43,SeqPrep,10000000,120,0,48,647196,11,647207,47.69650520672401
44,SeqPrep,10000000,120,0,50,628361,7,628368,49.53116020221785
45,SeqPrep,10000000,120,0,49,780787,10,780797,48.92538136003476
46,SeqPrep,10000000,120,0,53,1066364,5,1066369,53.289375070466896
47,SeqPrep,10000000,120,0,51,2315280,19,2315299,50.8585348324131
48,SeqPrep,10000000,120,0,53,2319133,13,2319146,52.51384737857001
49,SeqPrep,10000000,120,0,54,2960775,13,2960788,53.5746395959907
50,SeqPrep,10000000,120,0,57,2241660,5,2241665,56.516007067231186
51,SeqPrep,10000000,120,0,55,7582295,22,7582317,55.3737925654503
52,SeqPrep,10000000,120,0,57,17355410,35,17355445,56.95367709270337
53,SeqPrep,10000000,120,0,58,26054032,45,26054077,57.62663178545816
54,SeqPrep,10000000,120,0,58,31939332,46,31939378,58.41568622581815
55,SeqPrep,10000000,120,0,54,718779,3,718782,53.794759380932405
56,SeqPrep,10000000,120,0,61,2303193,2,2303195,60.61300713398313
57,SeqPrep,10000000,120,0,58,1193920,2,1193922,57.75945959206332
58,SeqPrep,10000000,120,0,100,916623,0,916623,100.0
59,SeqPrep,10000000,120,0,63,2051046,1,2051047,63.119756123950744
60,SeqPrep,10000000,120,0,76,1069733272,27,1069733299,75.97911750713027
0,SeqPrep,10000000,120,-10,3,1079979,1112796,2192775,2.9457851524026686
1,SeqPrep,10000000,120,-10,3,410530,370144,780674,3.2409900171927597
2,SeqPrep,10000000,120,-10,4,278366,189036,467402,3.931460473397018
3,SeqPrep,10000000,120,-10,5,206666,107916,314582,4.646480297342629
4,SeqPrep,10000000,120,-10,5,300488,119439,419927,5.4602764070743435
5,SeqPrep,10000000,120,-10,6,238156,76115,314271,6.158340557387253
6,SeqPrep,10000000,120,-10,7,82217,20663,102880,6.971375798844333
7,SeqPrep,10000000,120,-10,8,201573,40106,241679,7.800295658028529
8,SeqPrep,10000000,120,-10,9,146166,22453,168619,8.756321330173273
9,SeqPrep,10000000,120,-10,10,487701,57329,545030,9.780460413725443
10,SeqPrep,10000000,120,-10,11,530924,45829,576753,10.99849481260011
11,SeqPrep,10000000,120,-10,12,759494,49226,808720,12.156036361751713
12,SeqPrep,10000000,120,-10,13,500272,25781,526053,13.09729742790247
13,SeqPrep,10000000,120,-10,13,614010,28864,642874,13.477693459163447
14,SeqPrep,10000000,120,-10,14,313604,11613,325217,14.472288132611002
15,SeqPrep,10000000,120,-10,15,402860,11951,414811,15.404460181365494
16,SeqPrep,10000000,120,-10,17,199896,4367,204263,16.700065141575365
17,SeqPrep,10000000,120,-10,18,422004,7241,429245,17.72906697563672
18,SeqPrep,10000000,120,-10,19,727977,10024,738001,18.67015892311457
19,SeqPrep,10000000,120,-10,20,1347479,14132,1361611,19.838494225117852
20,SeqPrep,10000000,120,-10,21,1708425,14526,1722951,20.741268866463237
21,SeqPrep,10000000,120,-10,22,1767724,11252,1778976,21.989403656037613
22,SeqPrep,10000000,120,-10,22,8916891,50855,8967746,22.46349640273968
23,SeqPrep,10000000,120,-10,24,8563134,37320,8600454,23.62579742272664
24,SeqPrep,10000000,120,-10,25,6545197,22062,6567259,24.73739264107685
25,SeqPrep,10000000,120,-10,26,3168609,7915,3176524,26.03501221766213
26,SeqPrep,10000000,120,-10,28,637945,962,638907,28.222625743424402
27,SeqPrep,10000000,120,-10,29,1393874,1594,1395468,29.422315649091185
28,SeqPrep,10000000,120,-10,31,1652059,1412,1653471,30.68561885569666
29,SeqPrep,10000000,120,-10,32,2053009,1212,2054221,32.29144544804623
30,SeqPrep,10000000,120,-10,33,1547108,738,1547846,33.21671387368006
31,SeqPrep,10000000,120,-10,33,4382841,2086,4384927,33.22648063563411
32,SeqPrep,10000000,120,-10,35,11054788,3724,11058512,34.7268702123582
33,SeqPrep,10000000,120,-10,36,18269356,4432,18273788,36.15228830496823
34,SeqPrep,10000000,120,-10,38,24242700,4259,24246959,37.55349638025977
35,SeqPrep,10000000,120,-10,40,660379,69,660448,39.80989538628767
36,SeqPrep,10000000,120,-10,40,2017582,205,2017787,39.931214586216846
37,SeqPrep,10000000,120,-10,42,1125784,68,1125852,42.18972390945999
38,SeqPrep,10000000,120,-10,42,872479,51,872530,42.332101920381184
39,SeqPrep,10000000,120,-10,43,1918133,93,1918226,43.14416824651289
40,SeqPrep,10000000,120,-10,45,1793340,61,1793401,44.683475725747314
41,SeqPrep,10000000,120,-10,46,5367712,138,5367850,45.89921284939565
42,SeqPrep,10000000,120,-10,46,5765938,132,5766070,46.40305979206589
43,SeqPrep,10000000,120,-10,48,12266446,213,12266659,47.60346689080982
44,SeqPrep,10000000,120,-10,49,6624647,91,6624738,48.62127314830506
45,SeqPrep,10000000,120,-10,50,13028743,139,13028882,49.718923505266275
46,SeqPrep,10000000,120,-10,51,12049454,98,12049552,50.89744824534179
47,SeqPrep,10000000,120,-10,51,19327840,143,19327983,51.30850497490802
48,SeqPrep,10000000,120,-10,53,7032513,34,7032547,53.15633726286621
49,SeqPrep,10000000,120,-10,55,21189663,74,21189737,54.5689384669395
50,SeqPrep,10000000,120,-10,54,12132858,48,12132906,54.0272359552824
51,SeqPrep,10000000,120,-10,57,44464925,94,44465019,56.74890628627007
52,SeqPrep,10000000,120,-10,57,74419950,157,74420107,56.757906376981595
53,SeqPrep,10000000,120,-10,57,31978756,57,31978813,57.48987483752819
54,SeqPrep,10000000,120,-10,58,50194234,71,50194305,58.493960965658104
55,SeqPrep,10000000,120,-10,61,71142157,59,71142216,60.81275377202879
56,SeqPrep,10000000,120,-10,61,660857901,555,660858456,60.75815468252902
0,SeqPrep,10000000,120,-20,2,349456,517386,866842,2.241252725579887
1,SeqPrep,10000000,120,-20,3,62008,53672,115680,3.335105010826427
2,SeqPrep,10000000,120,-20,4,58108,37715,95823,4.049556514546173
3,SeqPrep,10000000,120,-20,4,57409,33949,91358,4.299195972264471
4,SeqPrep,10000000,120,-20,5,118403,50298,168701,5.2556694039883824
5,SeqPrep,10000000,120,-20,6,109747,40752,150499,5.6738468662311465
6,SeqPrep,10000000,120,-20,7,62403,17623,80026,6.571512685435865
7,SeqPrep,10000000,120,-20,7,132270,29178,161448,7.4297714944258715
8,SeqPrep,10000000,120,-20,8,73437,13398,86835,8.11654835167403
9,SeqPrep,10000000,120,-20,9,205932,27722,233654,9.257486610670137
10,SeqPrep,10000000,120,-20,11,142517,13766,156283,10.551039741083915
11,SeqPrep,10000000,120,-20,11,230890,18629,249519,11.26914078521693
12,SeqPrep,10000000,120,-20,12,135065,8331,143396,12.358399024814116
13,SeqPrep,10000000,120,-20,13,412945,20986,433931,13.15491008678115
14,SeqPrep,10000000,120,-20,14,427269,18928,446197,13.724219187002129
15,SeqPrep,10000000,120,-20,15,246935,7901,254836,15.085787178204539
16,SeqPrep,10000000,120,-20,16,226684,6061,232745,15.843360759087453
17,SeqPrep,10000000,120,-20,17,363371,7545,370916,16.916163235438738
18,SeqPrep,10000000,120,-20,17,4820498,90254,4910752,17.35681543532834
19,SeqPrep,10000000,120,-20,20,81030,749,81779,20.381599779644706
20,SeqPrep,10000000,120,-20,23,109098,595,109693,22.65661948460827
21,SeqPrep,10000000,120,-20,23,293096,1379,294475,23.294841642786377
22,SeqPrep,10000000,120,-20,25,362392,1173,363565,24.912840553978178
23,SeqPrep,10000000,120,-20,26,805128,1933,807061,26.20674507164647
24,SeqPrep,10000000,120,-20,28,480519,820,481339,27.6863719898532
25,SeqPrep,10000000,120,-20,29,984001,1299,985300,28.799593317166995
26,SeqPrep,10000000,120,-20,30,944318,885,945203,30.2858182068123
27,SeqPrep,10000000,120,-20,31,1563587,1223,1564810,31.070351557976686
28,SeqPrep,10000000,120,-20,32,595981,346,596327,32.364083746239814
29,SeqPrep,10000000,120,-20,34,1793421,801,1794222,33.50243661425451
30,SeqPrep,10000000,120,-20,35,1052766,357,1053123,34.69810881665553
31,SeqPrep,10000000,120,-20,35,3873834,1149,3874983,35.279497728579436
32,SeqPrep,10000000,120,-20,37,6539146,1453,6540599,36.53351909329325
33,SeqPrep,10000000,120,-20,38,2807283,499,2807782,37.50262839931118
34,SeqPrep,10000000,120,-20,39,4432116,582,4432698,38.81745159146333
35,SeqPrep,10000000,120,-20,39,6315016,732,6315748,39.359137121599424
36,SeqPrep,10000000,120,-20,41,58861475,5177,58866652,40.55791171335278
