program,filename,nfrags,fraglen,total_sequences,total_reads,dropped_reads,avg_divergence_per_nt,edit_distances
fastp,gen_n1000000_l1000_merged.fq,1000000,1000,999921,26674,973247,85.597,761:981 762:681 763:405 764:603 765:932 766:386 767:255 768:313 769:489 770:673 771:164 772:146 773:317 774:426 775:656 776:187 777:142 778:288 779:528 780:436 781:88 782:92 783:232 784:320 785:243 786:59 787:110 788:171 789:204 790:162 791:53 792:47 793:138 794:129 795:82 796:73 797:60 798:72 799:51 800:47 801:5 802:13 803:23 804:64 805:33 806:8 807:16 808:38 809:46 810:37 811:18 812:16 813:52 814:42 815:34 816:28 817:17 818:47 819:71 820:36 821:11 822:34 823:47 824:65 825:38 826:10 827:21 828:48 829:92 830:64 831:25 832:193 833:58 834:80 835:48 836:44 837:35 838:54 839:74 840:93 841:7 842:23 843:62 844:74 845:41 846:56 847:47 848:104 849:410 850:1259 851:183 852:78 853:133 854:223 855:134 856:34 857:41 858:107 859:59 860:43 861:26 862:29 863:81 864:107 865:46 866:39 867:31 868:85 869:83 870:60 871:31 872:43 873:123 874:230 875:72 876:12 877:59 878:41 879:23 880:29 881:28 882:50 883:29 884:28 885:15 886:7 887:16 888:18 889:23 890:18 891:7 892:8 893:21 894:25 895:11 896:5 897:7 898:20 899:21 900:14 901:3 902:9 903:13 904:30 905:13 906:9 907:14 908:27 909:57 910:49 911:7 912:12 913:54 914:64 915:27 916:27 917:8 918:46 919:74 920:22 921:10 922:19 923:45 924:125 925:16 926:12 927:4 928:14 929:14 930:19 931:8 932:11 933:31 934:15 935:24 936:41 937:8 938:15 939:30 940:6 941:4 942:8 943:13 944:24 945:12 946:4 947:7 948:18 949:24 950:18 951:5 952:16 953:34 954:40 955:29 956:41 957:35 958:59 959:102 960:90 961:169 962:79 963:94 964:224 965:268 966:356 967:61 968:174 969:226 970:150 971:104 972:134 973:225 974:357 975:283 976:92 977:79 978:210 979:403 980:347 981:119 982:143 983:307 984:388 985:385 986:142 987:221 988:551 989:810
fastp,gen_n1000000_l100_merged.fq,1000000,100,999928,1000000,-72,0.11,0:898035 1:96082 2:5118 3:239 4:146 5:218 6:97 7:11 8:13 9:3 10:26 11:2 12:6 13:3 14:1
fastp,gen_n1000000_l101_merged.fq,1000000,101,999921,1000000,-79,0.11,0:897081 1:96905 2:5285 3:241 4:136 5:216 6:86 7:13 8:11 9:3 10:14 11:1 12:7 13:1
fastp,gen_n1000000_l102_merged.fq,1000000,102,999926,1000000,-74,0.11,0:895965 1:97867 2:5443 3:214 4:151 5:223 6:89 7:9 8:10 9:5 10:15 11:3 12:4 13:2
fastp,gen_n1000000_l103_merged.fq,1000000,103,999915,1000000,-85,0.11,0:894504 1:99277 2:5473 3:227 4:136 5:243 6:81 7:21 8:11 9:7 10:12 11:2 12:5 14:1
fastp,gen_n1000000_l104_merged.fq,1000000,104,999911,1000000,-89,0.111,0:893316 1:100157 2:5781 3:241 4:119 5:242 6:91 7:12 8:11 9:4 10:12 11:5 12:6 13:2 15:1
fastp,gen_n1000000_l105_merged.fq,1000000,105,999920,1000000,-80,0.111,0:892233 1:101263 2:5767 3:242 4:139 5:211 6:88 7:18 8:11 9:4 10:17 11:3 12:4
fastp,gen_n1000000_l106_merged.fq,1000000,106,999938,1000000,-62,0.112,0:890311 1:103018 2:5892 3:264 4:129 5:224 6:97 7:17 8:9 9:8 10:18 11:1 12:11 15:1
fastp,gen_n1000000_l107_merged.fq,1000000,107,999913,1000000,-87,0.111,0:890004 1:103037 2:6183 3:265 4:117 5:255 6:77 7:11 8:15 9:5 10:18 11:4 12:6 13:2 14:1
fastp,gen_n1000000_l108_merged.fq,1000000,108,999922,1000000,-78,0.111,0:888778 1:104412 2:6057 3:257 4:135 5:212 6:92 7:21 8:10 9:4 10:12 11:3 12:6 13:1
fastp,gen_n1000000_l109_merged.fq,1000000,109,999923,1000000,-77,0.111,0:887600 1:105471 2:6136 3:297 4:134 5:218 6:88 7:17 8:11 9:3 10:14 11:4 12:7
fastp,gen_n1000000_l10_merged.fq,1000000,10,999901,3898,996003,12.237,1:3460 2:224 3:3 4:208 7:3
fastp,gen_n1000000_l110_merged.fq,1000000,110,999916,1000000,-84,0.111,0:886536 1:106368 2:6297 3:299 4:133 5:215 6:94 7:21 8:6 9:7 10:17 11:4 12:2 13:1
fastp,gen_n1000000_l111_merged.fq,1000000,111,999908,1000000,-92,0.111,0:885810 1:106994 2:6426 3:300 4:120 5:211 6:78 7:18 8:14 9:3 10:18 11:6 12:2
fastp,gen_n1000000_l112_merged.fq,1000000,112,999924,1000000,-76,0.112,0:884463 1:108135 2:6587 3:296 4:147 5:207 6:102 7:19 8:11 9:4 10:18 11:8 12:2 24:1
fastp,gen_n1000000_l113_merged.fq,1000000,113,999914,1000000,-86,0.112,0:883283 1:109082 2:6871 3:291 4:133 5:205 6:78 7:25 8:15 9:5 10:8 11:4
fastp,gen_n1000000_l114_merged.fq,1000000,114,999932,1000000,-68,0.111,0:882610 1:109721 2:6876 3:308 4:122 5:211 6:88 7:30 8:10 9:3 10:18 11:2 35:1
fastp,gen_n1000000_l115_merged.fq,1000000,115,999935,1000000,-65,0.112,0:881349 1:110847 2:6991 3:325 4:134 5:228 6:93 7:22 8:5 9:4 10:1 11:1
fastp,gen_n1000000_l116_merged.fq,1000000,116,999926,1000000,-74,0.112,0:880043 1:112040 2:7109 3:324 4:169 5:208 6:84 7:18 8:4 9:1
fastp,gen_n1000000_l117_merged.fq,1000000,117,999917,1000000,-83,0.112,0:879124 1:112882 2:7182 3:362 4:111 5:202 6:105 7:21 8:5 9:2 18:1 24:1 27:1 34:1
fastp,gen_n1000000_l118_merged.fq,1000000,118,999936,999999,-63,0.115,0:878138 1:113745 2:7256 3:351 4:129 5:193 6:64 7:15 8:11 9:1 10:8 12:3 15:1 17:1 18:1 20:2 22:1 23:1 24:3 26:2 28:4 29:3 30:1 31:1 32:7 33:2 34:1 35:4 36:3 38:1 40:2 41:1 42:3 43:1 44:1 47:1 48:1 49:3 50:1 51:1 52:4 54:2 55:1 56:1 57:1 58:2 59:1 60:4 61:1 63:1 64:6 65:1 67:1 68:1 70:1 72:1 75:1 117:1
fastp,gen_n1000000_l119_merged.fq,1000000,119,999928,1000000,-72,0.117,0:876493 1:115159 2:7487 3:359 4:113 5:158 6:55 7:11 8:8 10:17 11:3 12:1 14:1 15:2 17:1 18:2 20:1 21:1 22:2 24:2 25:2 26:1 27:4 28:7 29:5 30:6 31:4 32:5 33:6 34:2 35:3 36:3 38:4 40:7 41:5 42:4 43:1 44:3 45:4 47:1 48:2 49:1 50:1 51:1 52:1 53:3 54:3 55:2 57:1 59:3 60:3 62:2 63:3 64:6 65:2 66:2 67:2 71:2 73:1 74:2 75:1 76:3
fastp,gen_n1000000_l11_merged.fq,1000000,11,999928,999994,-66,0.136,0:985856 1:13525 2:549 3:1 4:1 5:61 6:1
fastp,gen_n1000000_l120_merged.fq,1000000,120,999913,1000000,-87,0.119,0:875133 1:116448 2:7664 3:383 4:100 5:42 6:18 7:3 8:8 9:2 11:1 12:2 14:2 15:3 16:1 17:1 19:3 20:3 21:1 23:1 24:6 25:2 26:6 27:2 28:5 29:4 30:7 31:3 32:9 33:4 34:3 35:3 36:9 37:3 38:3 39:3 40:8 41:3 42:9 43:1 44:3 45:2 46:5 47:1 48:1 49:3 50:4 51:3 52:3 53:3 54:2 55:3 56:3 57:1 59:1 60:2 61:1 62:4 63:4 64:10 65:3 66:4 67:1 68:2 69:2 70:5 72:2 73:1 75:3 95:1 99:1 104:1 105:1 115:1 118:1
fastp,gen_n1000000_l121_merged.fq,1000000,121,999915,1000000,-85,0.251,0:872023 1:116613 2:7679 3:355 4:169 5:332 6:136 7:34 8:10 9:5 10:22 11:6 12:15 13:4 14:5 15:22 16:8 17:6 18:13 19:8 20:33 21:8 22:19 23:18 24:30 25:25 26:52 27:28 28:48 29:38 30:63 31:38 32:51 33:38 34:50 35:65 36:56 37:17 38:30 39:28 40:42 41:18 42:112 43:21 44:16 45:26 46:15 47:23 48:26 49:28 50:26 51:22 52:15 53:34 54:17 55:38 56:29 57:11 58:10 59:18 60:40 61:22 62:14 63:21 64:136 65:34 66:13 67:19 68:21 69:18 70:35 71:11 72:12 73:5 74:13 75:25 76:6 77:6 78:3 79:2 80:2 81:1 83:1 84:7 85:12 86:2 87:4 88:2 89:3 90:18 91:6 92:2 93:8 94:5 95:22 96:9 97:12 98:19 99:8 100:46 101:36 102:12 103:7 104:40 105:17 106:3 107:6 108:7 109:24 110:5 111:5 112:8 113:13 114:60 115:11 116:19 117:93 118:238 119:4
fastp,gen_n1000000_l122_merged.fq,1000000,122,999926,1000000,-74,0.337,0:868862 1:118143 2:7898 3:386 4:143 5:429 6:214 7:35 8:16 9:4 10:41 11:16 12:15 13:4 14:5 15:37 16:13 17:9 18:22 19:18 20:41 21:13 22:25 23:25 24:47 25:31 26:47 27:31 28:44 29:40 30:70 31:34 32:40 33:41 34:43 35:55 36:37 37:32 38:40 39:32 40:44 41:36 42:152 43:35 44:22 45:40 46:36 47:27 48:27 49:39 50:47 51:21 52:20 53:23 54:24 55:42 56:20 57:16 58:16 59:15 60:58 61:16 62:24 63:31 64:115 65:43 66:24 67:22 68:20 69:27 70:28 71:14 72:15 73:13 74:18 75:41 76:15 77:8 78:10 79:8 80:9 81:4 82:5 83:2 84:27 85:19 86:6 87:8 88:8 89:6 90:50 91:9 92:10 93:10 94:18 95:123 96:10 97:11 98:54 99:28 100:221 101:76 102:44 103:22 104:43 105:113 106:19 107:13 108:21 109:27 110:57 111:12 112:25 113:57 114:21 115:42 116:108 117:327 118:5
fastp,gen_n1000000_l123_merged.fq,1000000,123,999926,1000000,-74,0.521,0:865925 1:118132 2:8039 3:442 4:170 5:523 6:277 7:48 8:15 9:7 10:56 11:13 12:11 13:6 14:3 15:34 16:28 17:9 18:18 19:10 20:54 21:20 22:17 23:33 24:44 25:43 26:68 27:38 28:55 29:31 30:80 31:45 32:43 33:64 34:58 35:54 36:59 37:39 38:47 39:44 40:70 41:24 42:196 43:41 44:35 45:48 46:29 47:28 48:37 49:60 50:61 51:34 52:32 53:27 54:33 55:48 56:26 57:28 58:16 59:30 60:62 61:30 62:17 63:25 64:150 65:44 66:19 67:18 68:31 69:35 70:63 71:7 72:20 73:17 74:16 75:43 76:14 77:16 78:9 79:10 80:31 81:7 82:11 83:7 84:76 85:77 86:20 87:16 88:22 89:15 90:185 91:17 92:21 93:15 94:49 95:334 96:46 97:42 98:160 99:87 100:641 101:140 102:77 103:32 104:113 105:382 106:39 107:39 108:25 109:48 110:237 111:51 112:73 113:31 114:77 115:247 116:258 117:1
fastp,gen_n1000000_l124_merged.fq,1000000,124,999907,1000000,-93,0.968,0:859412 1:118703 2:8116 3:458 4:183 5:714 6:266 7:67 8:17 9:6 10:47 11:22 12:25 13:10 14:16 15:45 16:38 17:16 18:25 19:17 20:63 21:27 22:20 23:45 24:55 25:50 26:78 27:45 28:55 29:38 30:93 31:51 32:55 33:46 34:53 35:58 36:47 37:47 38:49 39:30 40:68 41:35 42:255 43:46 44:33 45:64 46:30 47:32 48:26 49:98 50:55 51:28 52:24 53:20 54:42 55:84 56:32 57:18 58:15 59:25 60:105 61:35 62:18 63:47 64:160 65:64 66:37 67:24 68:37 69:27 70:57 71:13 72:25 73:15 74:19 75:62 76:11 77:15 78:24 79:18 80:70 81:22 82:23 83:23 84:174 85:163 86:33 87:33 88:34 89:29 90:390 91:31 92:36 93:34 94:165 95:680 96:65 97:129 98:479 99:169 100:1229 101:341 102:79 103:60 104:301 105:860 106:113 107:42 108:83 109:171 110:847 111:264 112:72 113:116 114:451 115:1133 116:5
fastp,gen_n1000000_l125_merged.fq,1000000,125,999938,1000000,-62,0.116,0:869668 1:120353 2:8414 3:390 4:12 5:729 6:185 7:12 8:143 9:65 10:22 11:3 12:3 14:1
fastp,gen_n1000000_l126_merged.fq,1000000,126,999918,1000000,-82,0.111,0:869174 1:121835 2:8554 3:425 4:10 5:1 11:1
fastp,gen_n1000000_l127_merged.fq,1000000,127,999911,1000000,-89,0.112,0:867600 1:123018 2:8810 3:510 4:50 5:9 6:3
fastp,gen_n1000000_l128_merged.fq,1000000,128,999924,1000000,-76,0.113,0:866010 1:124493 2:8870 3:545 4:71 5:9 6:1 7:1
fastp,gen_n1000000_l129_merged.fq,1000000,129,999908,1000000,-92,0.114,0:864363 1:125646 2:9075 3:463 4:241 5:144 6:51 7:13 8:3 9:1
fastp,gen_n1000000_l12_merged.fq,1000000,12,999912,999992,-80,0.127,0:985906 1:13559 2:185 3:74 4:266 5:1 6:1
fastp,gen_n1000000_l130_merged.fq,1000000,130,999922,1000000,-78,0.119,0:861186 1:127541 2:9388 3:495 4:230 5:779 6:292 7:74 8:15
fastp,gen_n1000000_l131_merged.fq,1000000,131,999914,1000000,-86,0.121,0:859105 1:129143 2:9710 3:518 4:218 5:704 6:444 7:132 8:20 9:4 10:1 16:1
fastp,gen_n1000000_l132_merged.fq,1000000,132,999903,1000000,-97,0.121,0:857660 1:130409 2:9841 3:558 4:202 5:786 6:383 7:118 8:32 9:7 10:3 11:1
fastp,gen_n1000000_l133_merged.fq,1000000,133,999924,1000000,-76,0.122,0:856491 1:131162 2:10236 3:564 4:113 5:683 6:394 7:104 8:151 9:70 10:20 11:10 12:1 13:1
fastp,gen_n1000000_l134_merged.fq,1000000,134,999910,1000000,-90,0.123,0:854411 1:133266 2:10158 3:613 4:113 5:702 6:359 7:85 8:165 9:84 10:31 11:9 12:4
fastp,gen_n1000000_l135_merged.fq,1000000,135,999914,1000000,-86,0.126,0:853298 1:134144 2:10331 3:601 4:109 5:314 6:198 7:48 8:114 9:73 10:513 11:196 12:54 13:7
fastp,gen_n1000000_l136_merged.fq,1000000,136,999919,1000000,-81,0.127,0:850891 1:136140 2:10699 3:625 4:135 5:304 6:189 7:55 8:122 9:80 10:491 11:213 12:45 13:8 14:3
fastp,gen_n1000000_l137_merged.fq,1000000,137,999921,1000000,-79,0.128,0:850474 1:136266 2:10930 3:605 4:107 5:322 6:149 7:47 8:68 9:46 10:485 11:236 12:170 13:57 14:29 15:8 16:1
fastp,gen_n1000000_l138_merged.fq,1000000,138,999916,1000000,-84,0.128,0:848086 1:138475 2:11147 3:606 4:125 5:299 6:133 7:43 8:70 9:30 10:541 11:208 12:157 13:58 14:17 15:3 16:1 17:1
fastp,gen_n1000000_l139_merged.fq,1000000,139,999922,1000000,-78,0.129,0:846679 1:139596 2:11329 3:683 4:120 5:331 6:166 7:37 8:59 9:42 10:466 11:217 12:153 13:68 14:41 15:11 16:2
fastp,gen_n1000000_l13_merged.fq,1000000,13,999925,999990,-65,0.139,0:984425 1:13113 2:2396 3:56
fastp,gen_n1000000_l140_merged.fq,1000000,140,999928,1000000,-72,0.131,0:845387 1:140579 2:11609 3:663 4:148 5:268 6:144 7:52 8:56 9:41 10:206 11:93 12:114 13:49 14:39 15:371 16:148 17:30 18:3
fastp,gen_n1000000_l141_merged.fq,1000000,141,999935,1000000,-65,0.133,0:843646 1:142025 2:11792 3:700 4:136 5:300 6:139 7:45 8:55 9:42 10:220 11:93 12:96 13:35 14:25 15:363 16:202 17:64 18:16 19:5 20:1
fastp,gen_n1000000_l142_merged.fq,1000000,142,999939,1000000,-61,0.134,0:842014 1:143252 2:12061 3:751 4:133 5:314 6:154 7:53 8:52 9:43 10:226 11:98 12:72 13:23 14:18 15:409 16:219 17:91 18:10 19:7
fastp,gen_n1000000_l143_merged.fq,1000000,143,999923,1000000,-77,0.135,0:840260 1:144861 2:12250 3:700 4:139 5:295 6:161 7:54 8:60 9:32 10:207 11:89 12:63 13:35 14:24 15:378 16:215 17:67 18:81 19:24 20:3 21:1 22:1
fastp,gen_n1000000_l144_merged.fq,1000000,144,999931,1000000,-69,0.134,0:839710 1:144950 2:12702 3:801 4:129 5:275 6:134 7:49 8:49 9:27 10:202 11:92 12:76 13:25 14:21 15:369 16:186 17:66 18:94 19:30 20:11 21:2
fastp,gen_n1000000_l145_merged.fq,1000000,145,999928,1000000,-72,0.138,0:837100 1:147196 2:12937 3:784 4:130 5:289 6:146 7:47 8:57 9:33 10:158 11:91 12:58 13:35 14:33 15:137 16:97 17:35 18:71 19:25 20:363 21:135 22:39 23:3 24:1
fastp,gen_n1000000_l146_merged.fq,1000000,146,999929,1000000,-71,0.138,0:836182 1:148061 2:12974 3:792 4:141 5:296 6:120 7:49 8:50 9:35 10:186 11:88 12:56 13:28 14:13 15:148 16:93 17:40 18:63 19:20 20:349 21:163 22:44 23:8 30:1
fastp,gen_n1000000_l147_merged.fq,1000000,147,999921,1000000,-79,0.139,0:834068 1:149712 2:13422 3:809 4:142 5:286 6:129 7:35 8:45 9:29 10:197 11:72 12:49 13:25 14:20 15:144 16:88 17:35 18:46 19:22 20:394 21:148 22:60 23:17 24:6
fastp,gen_n1000000_l148_merged.fq,1000000,148,999912,1000000,-88,0.141,0:832307 1:151105 2:13717 3:812 4:138 5:302 6:119 7:37 8:58 9:29 10:182 11:73 12:48 13:16 14:16 15:153 16:89 17:31 18:74 19:27 20:376 21:131 22:71 23:63 24:22 25:4
fastp,gen_n1000000_l149_merged.fq,1000000,149,999919,1000000,-81,0.141,0:831489 1:151770 2:13759 3:866 4:144 5:294 6:148 7:55 8:52 9:35 10:184 11:73 12:41 13:19 14:16 15:153 16:86 17:30 18:48 19:17 20:313 21:139 22:37 23:50 24:144 25:29 26:9
fastp,gen_n1000000_l14_merged.fq,1000000,14,999918,999991,-73,0.145,0:982448 1:15177 2:2140 3:58 4:168
fastp,gen_n1000000_l150_merged.fq,1000000,150,999914,1000000,-86,0.144,0:829461 1:153490 2:14008 3:929 4:152 5:242 6:118 7:37 8:47 9:38 10:170 11:68 12:47 13:21 14:11 15:143 16:88 17:39 18:46 19:19 20:155 21:88 22:46 23:53 24:147 25:239 26:81 27:15 28:2
fastp,gen_n1000000_l151_merged.fq,1000000,151,999923,999999,-76,0.145,0:828582 1:153805 2:14544 3:882 4:136 5:251 6:138 7:33 8:45 9:34 10:183 11:75 12:50 13:14 14:20 15:147 16:74 17:35 18:43 19:16 20:151 21:79 22:30 23:61 24:129 25:219 26:169 27:45 28:7 29:2
fastp,gen_n1000000_l152_merged.fq,1000000,152,999920,1000000,-80,0.147,0:827036 1:155273 2:14463 3:911 4:142 5:262 6:127 7:37 8:52 9:38 10:179 11:75 12:52 13:27 14:18 15:139 16:85 17:38 18:39 19:13 20:183 21:67 22:32 23:51 24:132 25:250 26:169 27:85 28:16 29:8 30:1
fastp,gen_n1000000_l153_merged.fq,1000000,153,999914,1000000,-86,0.149,0:824635 1:157113 2:14906 3:971 4:137 5:262 6:135 7:39 8:64 9:33 10:165 11:82 12:48 13:22 14:8 15:137 16:89 17:22 18:30 19:19 20:168 21:72 22:35 23:64 24:115 25:264 26:153 27:83 28:109 29:16 30:4
fastp,gen_n1000000_l154_merged.fq,1000000,154,999923,1000000,-77,0.15,0:823601 1:157902 2:15139 3:909 4:134 5:270 6:129 7:38 8:54 9:28 10:191 11:73 12:40 13:24 14:12 15:145 16:90 17:52 18:37 19:17 20:168 21:73 22:34 23:51 24:95 25:263 26:148 27:84 28:111 29:69 30:15 31:3 34:1
fastp,gen_n1000000_l155_merged.fq,1000000,155,999916,1000000,-84,0.153,0:821172 1:159989 2:15312 3:1022 4:144 5:288 6:130 7:35 8:63 9:34 10:166 11:71 12:38 13:24 14:13 15:116 16:62 17:25 18:45 19:21 20:146 21:59 22:31 23:44 24:71 25:124 26:123 27:70 28:101 29:72 30:290 31:84 32:14 33:1
fastp,gen_n1000000_l156_merged.fq,1000000,156,999920,1000000,-80,0.155,0:820274 1:160134 2:15930 3:1065 4:148 5:272 6:143 7:24 8:49 9:21 10:170 11:61 12:47 13:21 14:13 15:124 16:78 17:21 18:27 19:20 20:160 21:87 22:32 23:54 24:93 25:129 26:101 27:80 28:91 29:66 30:323 31:116 32:19 33:5 34:2
fastp,gen_n1000000_l157_merged.fq,1000000,157,999892,1000000,-108,0.157,0:818938 1:161416 2:15848 3:1073 4:140 5:294 6:127 7:36 8:58 9:26 10:173 11:73 12:37 13:22 14:17 15:143 16:84 17:29 18:28 19:19 20:142 21:58 22:32 23:72 24:94 25:134 26:128 27:61 28:82 29:47 30:333 31:123 32:92 33:17 34:3 42:1
fastp,gen_n1000000_l158_merged.fq,1000000,158,999933,1000000,-67,0.157,0:817408 1:162570 2:16298 3:1073 4:158 5:244 6:135 7:41 8:47 9:23 10:175 11:76 12:39 13:20 14:11 15:118 16:72 17:35 18:29 19:24 20:170 21:74 22:34 23:47 24:78 25:96 26:105 27:71 28:89 29:65 30:303 31:106 32:87 33:65 34:13 35:1
fastp,gen_n1000000_l159_merged.fq,1000000,159,999910,1000000,-90,0.16,0:816107 1:163638 2:16298 3:1105 4:157 5:265 6:134 7:40 8:47 9:40 10:174 11:66 12:45 13:15 14:9 15:138 16:83 17:27 18:36 19:24 20:168 21:67 22:26 23:55 24:74 25:130 26:103 27:80 28:93 29:59 30:302 31:113 32:114 33:64 34:87 35:16 37:1
fastp,gen_n1000000_l15_merged.fq,1000000,15,999906,1000000,-94,0.127,0:982664 1:15634 2:1664 3:37 4:1
fastp,gen_n1000000_l160_merged.fq,1000000,160,999911,1000000,-89,0.162,0:814702 1:164553 2:16739 3:1119 4:146 5:264 6:112 7:34 8:47 9:24 10:183 11:62 12:61 13:24 14:7 15:133 16:60 17:16 18:28 19:23 20:163 21:63 22:37 23:59 24:84 25:117 26:119 27:68 28:89 29:64 30:193 31:73 32:110 33:70 34:67 35:225 36:51 37:10 38:1
fastp,gen_n1000000_l161_merged.fq,1000000,161,999908,1000000,-92,0.164,0:812790 1:166114 2:16922 3:1181 4:194 5:263 6:121 7:28 8:54 9:37 10:175 11:74 12:49 13:23 14:17 15:141 16:73 17:23 18:25 19:15 20:165 21:58 22:29 23:50 24:79 25:129 26:113 27:68 28:76 29:60 30:160 31:86 32:71 33:58 34:69 35:212 36:159 37:35 38:2 39:2
fastp,gen_n1000000_l162_merged.fq,1000000,162,999910,1000000,-90,0.165,0:811573 1:167042 2:17217 3:1249 4:149 5:265 6:125 7:29 8:51 9:23 10:168 11:54 12:45 13:6 14:15 15:121 16:84 17:16 18:22 19:13 20:142 21:77 22:34 23:62 24:82 25:93 26:108 27:58 28:83 29:62 30:164 31:88 32:77 33:58 34:91 35:212 36:150 37:77 38:12 39:3
fastp,gen_n1000000_l163_merged.fq,1000000,163,999933,1000000,-67,0.166,0:809749 1:168480 2:17488 3:1250 4:190 5:240 6:136 7:43 8:47 9:28 10:155 11:74 12:44 13:16 14:12 15:138 16:67 17:14 18:23 19:11 20:165 21:68 22:28 23:52 24:80 25:116 26:110 27:77 28:74 29:54 30:156 31:74 32:80 33:53 34:77 35:221 36:171 37:60 38:64 39:14 45:1
fastp,gen_n1000000_l164_merged.fq,1000000,164,999915,1000000,-85,0.169,0:808357 1:169377 2:17840 3:1250 4:188 5:253 6:129 7:41 8:52 9:27 10:178 11:67 12:54 13:22 14:9 15:111 16:72 17:29 18:24 19:4 20:177 21:74 22:35 23:75 24:72 25:121 26:134 27:62 28:81 29:54 30:161 31:78 32:78 33:59 34:55 35:223 36:161 37:68 38:69 39:65 40:13 41:1
fastp,gen_n1000000_l165_merged.fq,1000000,165,999917,1000000,-83,0.173,0:806901 1:170498 2:18038 3:1306 4:180 5:255 6:121 7:42 8:74 9:25 10:164 11:46 12:53 13:16 14:7 15:117 16:59 17:25 18:15 19:11 20:133 21:51 22:25 23:55 24:93 25:131 26:125 27:63 28:92 29:65 30:169 31:74 32:81 33:67 34:69 35:92 36:128 37:68 38:67 39:53 40:269 41:64 42:10 43:1 44:1 48:1
fastp,gen_n1000000_l166_merged.fq,1000000,166,999915,1000000,-85,0.172,0:805420 1:171775 2:18299 3:1347 4:160 5:250 6:125 7:45 8:51 9:25 10:140 11:49 12:57 13:21 14:4 15:128 16:46 17:18 18:16 19:6 20:155 21:66 22:34 23:68 24:75 25:100 26:120 27:68 28:96 29:54 30:150 31:69 32:75 33:47 34:84 35:122 36:116 37:63 38:80 39:50 40:222 41:88 42:15 43:1
fastp,gen_n1000000_l167_merged.fq,1000000,167,999913,1000000,-87,0.184,0:802979 1:173442 2:18585 3:1363 4:185 5:226 6:125 7:40 8:58 9:35 10:167 11:57 12:47 13:14 14:11 15:110 16:56 17:23 18:11 19:10 20:149 21:66 22:19 23:60 24:70 25:109 26:101 27:67 28:77 29:54 30:172 31:88 32:78 33:47 34:87 35:111 36:109 37:55 38:73 39:50 40:253 41:97 42:380 43:79 44:5
fastp,gen_n1000000_l168_merged.fq,1000000,168,999917,1000000,-83,0.182,0:802141 1:173991 2:18933 3:1410 4:150 5:217 6:123 7:43 8:39 9:21 10:164 11:58 12:37 13:18 14:12 15:122 16:69 17:27 18:16 19:7 20:133 21:52 22:21 23:60 24:80 25:129 26:115 27:44 28:71 29:72 30:168 31:84 32:65 33:53 34:73 35:97 36:109 37:47 38:80 39:55 40:230 41:108 42:340 43:98 44:17 45:1
fastp,gen_n1000000_l169_merged.fq,1000000,169,999922,1000000,-78,0.184,0:800445 1:175377 2:19081 3:1485 4:181 5:236 6:137 7:40 8:66 9:23 10:158 11:69 12:39 13:12 14:13 15:116 16:74 17:28 18:12 19:6 20:113 21:57 22:14 23:50 24:65 25:105 26:99 27:68 28:82 29:53 30:152 31:72 32:63 33:54 34:83 35:86 36:90 37:51 38:77 39:44 40:259 41:91 42:396 43:85 44:72 45:17 46:2 47:2
fastp,gen_n1000000_l16_merged.fq,1000000,16,999917,1000000,-83,0.128,0:982199 1:15898 2:1472 3:38 4:390 5:3
fastp,gen_n1000000_l170_merged.fq,1000000,170,999923,1000000,-77,0.188,0:798516 1:176605 2:19647 3:1445 4:190 5:262 6:136 7:31 8:64 9:31 10:150 11:60 12:42 13:11 14:12 15:118 16:71 17:25 18:23 19:13 20:150 21:40 22:24 23:68 24:64 25:116 26:108 27:62 28:64 29:62 30:151 31:65 32:77 33:69 34:64 35:99 36:93 37:69 38:65 39:54 40:153 41:80 42:333 43:90 44:73 45:206 46:44 47:5
fastp,gen_n1000000_l171_merged.fq,1000000,171,999914,1000000,-86,0.189,0:797095 1:177899 2:19691 3:1493 4:179 5:254 6:104 7:32 8:54 9:34 10:175 11:67 12:34 13:22 14:7 15:97 16:71 17:22 18:25 19:8 20:130 21:67 22:26 23:61 24:74 25:92 26:95 27:75 28:71 29:66 30:163 31:92 32:82 33:54 34:85 35:87 36:93 37:58 38:52 39:50 40:160 41:61 42:384 43:105 44:54 45:202 46:83 47:9 48:5 49:1
fastp,gen_n1000000_l172_merged.fq,1000000,172,999922,999999,-77,0.19,0:795195 1:179233 2:20192 3:1524 4:193 5:268 6:136 7:41 8:47 9:24 10:178 11:61 12:40 13:10 14:9 15:115 16:59 17:16 18:19 19:12 20:128 21:61 22:11 23:40 24:67 25:100 26:96 27:66 28:63 29:41 30:172 31:86 32:83 33:55 34:79 35:119 36:92 37:64 38:75 39:56 40:130 41:68 42:362 43:110 44:77 45:196 46:79 47:44 48:6 49:1
fastp,gen_n1000000_l173_merged.fq,1000000,173,999927,1000000,-73,0.192,0:793948 1:180114 2:20430 3:1606 4:171 5:247 6:110 7:35 8:65 9:22 10:166 11:50 12:50 13:19 14:7 15:144 16:80 17:24 18:19 19:13 20:124 21:60 22:24 23:42 24:43 25:101 26:117 27:56 28:84 29:59 30:163 31:77 32:69 33:56 34:82 35:95 36:98 37:58 38:70 39:46 40:145 41:47 42:315 43:96 44:63 45:189 46:104 47:35 48:139 49:21 50:1 51:1
fastp,gen_n1000000_l174_merged.fq,1000000,174,999914,1000000,-86,0.193,0:792993 1:181000 2:20560 3:1513 4:195 5:256 6:142 7:42 8:48 9:24 10:142 11:68 12:37 13:16 14:5 15:102 16:57 17:19 18:24 19:4 20:145 21:46 22:20 23:38 24:55 25:90 26:117 27:62 28:52 29:62 30:157 31:79 32:83 33:58 34:82 35:102 36:86 37:45 38:65 39:50 40:131 41:73 42:346 43:97 44:65 45:171 46:89 47:43 48:120 49:94 50:26 51:3 52:1
fastp,gen_n1000000_l175_merged.fq,1000000,175,999925,1000000,-75,0.194,0:792153 1:181337 2:20959 3:1664 4:210 5:248 6:108 7:36 8:57 9:21 10:145 11:53 12:31 13:13 14:9 15:116 16:64 17:19 18:25 19:11 20:110 21:45 22:15 23:41 24:52 25:79 26:106 27:57 28:62 29:51 30:136 31:71 32:75 33:45 34:70 35:83 36:69 37:44 38:67 39:60 40:144 41:61 42:373 43:75 44:73 45:103 46:69 47:32 48:114 49:103 50:188 51:43 52:5
fastp,gen_n1000000_l176_merged.fq,1000000,176,999930,1000000,-70,0.198,0:789785 1:183198 2:21263 3:1664 4:216 5:218 6:117 7:25 8:51 9:27 10:178 11:55 12:51 13:22 14:11 15:116 16:75 17:20 18:15 19:8 20:130 21:44 22:22 23:35 24:53 25:82 26:110 27:73 28:71 29:62 30:145 31:81 32:77 33:43 34:74 35:104 36:87 37:58 38:64 39:54 40:143 41:52 42:359 43:83 44:50 45:113 46:55 47:38 48:110 49:109 50:216 51:74 52:10 53:4
fastp,gen_n1000000_l177_merged.fq,1000000,177,999920,1000000,-80,0.199,0:787850 1:184913 2:21542 3:1622 4:203 5:235 6:106 7:30 8:56 9:24 10:181 11:66 12:35 13:25 14:10 15:114 16:64 17:22 18:24 19:4 20:130 21:44 22:21 23:36 24:47 25:76 26:83 27:65 28:67 29:56 30:162 31:62 32:69 33:51 34:55 35:107 36:77 37:42 38:75 39:43 40:162 41:58 42:356 43:99 44:64 45:120 46:60 47:39 48:106 49:101 50:192 51:73 52:63 53:11 54:2
fastp,gen_n1000000_l178_merged.fq,1000000,178,999916,1000000,-84,0.201,0:786047 1:186344 2:21672 3:1717 4:223 5:260 6:116 7:30 8:63 9:26 10:177 11:57 12:53 13:23 14:12 15:133 16:62 17:18 18:19 19:9 20:128 21:52 22:27 23:38 24:51 25:92 26:86 27:68 28:67 29:63 30:152 31:94 32:54 33:39 34:68 35:108 36:70 37:60 38:58 39:59 40:123 41:61 42:329 43:95 44:59 45:93 46:65 47:57 48:106 49:106 50:199 51:82 52:85 53:39 54:6
fastp,gen_n1000000_l179_merged.fq,1000000,179,999920,1000000,-80,0.203,0:784848 1:186781 2:22326 3:1789 4:239 5:272 6:112 7:44 8:56 9:28 10:157 11:65 12:45 13:20 14:5 15:124 16:66 17:17 18:10 19:7 20:114 21:48 22:12 23:43 24:35 25:91 26:81 27:32 28:59 29:61 30:143 31:77 32:78 33:55 34:69 35:119 36:84 37:62 38:53 39:55 40:157 41:60 42:356 43:92 44:53 45:120 46:67 47:27 48:94 49:90 50:206 51:73 52:72 53:44 54:94 55:13
fastp,gen_n1000000_l17_merged.fq,1000000,17,999905,999999,-94,0.123,0:981737 1:16551 2:816 3:809 4:86
fastp,gen_n1000000_l180_merged.fq,1000000,180,999915,1000000,-85,0.206,0:783752 1:187792 2:22277 3:1797 4:238 5:249 6:109 7:31 8:62 9:27 10:185 11:46 12:45 13:21 14:10 15:128 16:77 17:19 18:20 19:15 20:124 21:31 22:25 23:41 24:48 25:102 26:76 27:30 28:65 29:72 30:142 31:86 32:70 33:58 34:65 35:99 36:72 37:55 38:62 39:45 40:143 41:65 42:341 43:99 44:52 45:101 46:69 47:41 48:89 49:104 50:124 51:73 52:81 53:49 54:95 55:167 56:36 57:2 58:1
fastp,gen_n1000000_l181_merged.fq,1000000,181,999924,1000000,-76,0.208,0:781820 1:189270 2:22721 3:1836 4:219 5:232 6:102 7:29 8:61 9:27 10:158 11:62 12:41 13:16 14:12 15:121 16:67 17:15 18:15 19:6 20:145 21:57 22:20 23:43 24:32 25:102 26:76 27:39 28:36 29:53 30:173 31:58 32:67 33:51 34:71 35:103 36:72 37:54 38:73 39:54 40:121 41:49 42:342 43:89 44:63 45:112 46:63 47:42 48:94 49:80 50:127 51:70 52:64 53:46 54:99 55:197 56:112 57:17 58:2 59:2
fastp,gen_n1000000_l182_merged.fq,1000000,182,999910,1000000,-90,0.208,0:780500 1:190374 2:22872 3:1915 4:219 5:242 6:124 7:32 8:62 9:20 10:169 11:55 12:43 13:13 14:3 15:101 16:71 17:18 18:15 19:9 20:123 21:45 22:20 23:46 24:35 25:86 26:80 27:39 28:30 29:59 30:154 31:70 32:73 33:52 34:77 35:106 36:94 37:52 38:59 39:56 40:135 41:63 42:320 43:95 44:56 45:111 46:56 47:31 48:85 49:81 50:123 51:59 52:66 53:51 54:93 55:182 56:125 57:44 58:10 61:1
fastp,gen_n1000000_l183_merged.fq,1000000,183,999924,1000000,-76,0.209,0:779264 1:190865 2:23601 3:1938 4:224 5:264 6:107 7:29 8:50 9:33 10:151 11:61 12:44 13:15 14:10 15:99 16:58 17:22 18:14 19:6 20:128 21:50 22:10 23:41 24:46 25:85 26:86 27:35 28:37 29:21 30:129 31:73 32:78 33:62 34:52 35:91 36:73 37:53 38:60 39:47 40:134 41:66 42:319 43:99 44:55 45:121 46:61 47:30 48:90 49:94 50:129 51:55 52:77 53:45 54:91 55:183 56:123 57:47 58:57 59:6 60:5 62:1
fastp,gen_n1000000_l184_merged.fq,1000000,184,999926,1000000,-74,0.212,0:777056 1:192639 2:23864 3:1967 4:222 5:233 6:117 7:21 8:58 9:22 10:165 11:61 12:39 13:17 14:11 15:120 16:61 17:17 18:21 19:13 20:137 21:72 22:22 23:47 24:59 25:101 26:68 27:38 28:32 29:20 30:148 31:70 32:72 33:51 34:59 35:95 36:76 37:45 38:43 39:48 40:133 41:66 42:323 43:79 44:50 45:99 46:70 47:48 48:90 49:114 50:145 51:61 52:67 53:39 54:103 55:207 56:118 57:57 58:65 59:32 60:5 61:2
fastp,gen_n1000000_l185_merged.fq,1000000,185,999927,1000000,-73,0.216,0:775638 1:193294 2:24476 3:2065 4:229 5:224 6:103 7:23 8:56 9:21 10:178 11:58 12:34 13:20 14:14 15:129 16:55 17:16 18:19 19:4 20:141 21:43 22:21 23:47 24:47 25:86 26:92 27:41 28:36 29:21 30:91 31:62 32:61 33:65 34:58 35:90 36:66 37:49 38:58 39:55 40:118 41:55 42:321 43:103 44:49 45:97 46:64 47:37 48:80 49:95 50:133 51:66 52:70 53:40 54:75 55:140 56:115 57:35 58:73 59:27 60:265 61:49 62:6 63:1
fastp,gen_n1000000_l186_merged.fq,1000000,186,999915,1000000,-85,0.217,0:773674 1:194955 2:24646 3:2120 4:244 5:251 6:100 7:23 8:71 9:24 10:181 11:58 12:39 13:14 14:10 15:146 16:62 17:29 18:18 19:10 20:127 21:44 22:13 23:34 24:43 25:88 26:79 27:32 28:36 29:24 30:98 31:66 32:75 33:54 34:69 35:119 36:85 37:60 38:70 39:46 40:120 41:56 42:306 43:76 44:54 45:97 46:62 47:32 48:94 49:81 50:127 51:65 52:75 53:42 54:88 55:130 56:103 57:41 58:47 59:35 60:259 61:64 62:8 63:1
fastp,gen_n1000000_l187_merged.fq,1000000,187,999925,1000000,-75,0.218,0:772056 1:196505 2:24800 3:2089 4:237 5:236 6:86 7:37 8:59 9:20 10:142 11:63 12:50 13:20 14:6 15:116 16:73 17:16 18:18 19:15 20:118 21:30 22:18 23:41 24:38 25:88 26:79 27:34 28:39 29:16 30:116 31:42 32:57 33:41 34:80 35:89 36:69 37:57 38:60 39:49 40:113 41:70 42:346 43:87 44:55 45:95 46:61 47:31 48:62 49:83 50:150 51:71 52:68 53:47 54:80 55:119 56:103 57:44 58:43 59:31 60:280 61:82 62:66 63:6 64:1 66:1
fastp,gen_n1000000_l188_merged.fq,1000000,188,999917,1000000,-83,0.218,0:771229 1:196936 2:25071 3:2166 4:241 5:260 6:98 7:18 8:48 9:22 10:168 11:54 12:47 13:15 14:9 15:121 16:46 17:11 18:15 19:13 20:135 21:52 22:24 23:43 24:40 25:80 26:72 27:31 28:40 29:23 30:106 31:54 32:55 33:52 34:67 35:94 36:77 37:51 38:63 39:64 40:118 41:67 42:352 43:89 44:54 45:92 46:52 47:32 48:78 49:104 50:126 51:56 52:57 53:40 54:68 55:103 56:87 57:50 58:45 59:39 60:271 61:64 62:67 63:68 64:8 65:1 66:1
fastp,gen_n1000000_l189_merged.fq,1000000,189,999930,1000000,-70,0.225,0:769795 1:198009 2:25229 3:2144 4:251 5:238 6:108 7:20 8:60 9:22 10:188 11:56 12:47 13:25 14:5 15:91 16:62 17:23 18:14 19:9 20:130 21:43 22:21 23:60 24:51 25:74 26:82 27:38 28:27 29:23 30:125 31:42 32:33 33:52 34:66 35:96 36:75 37:37 38:62 39:33 40:131 41:60 42:331 43:100 44:57 45:88 46:50 47:33 48:63 49:99 50:129 51:75 52:68 53:41 54:87 55:113 56:85 57:36 58:51 59:36 60:292 61:88 62:57 63:41 64:197 65:23 66:3
fastp,gen_n1000000_l18_merged.fq,1000000,18,999914,1000000,-86,0.127,0:980684 1:16949 2:1403 3:680 4:282 6:2
fastp,gen_n1000000_l190_merged.fq,1000000,190,999924,1000000,-76,0.231,0:767375 1:199457 2:25989 3:2252 4:236 5:242 6:117 7:28 8:72 9:22 10:131 11:51 12:48 13:17 14:6 15:109 16:79 17:17 18:17 19:7 20:127 21:50 22:20 23:44 24:43 25:94 26:83 27:23 28:24 29:24 30:98 31:49 32:36 33:48 34:51 35:82 36:64 37:49 38:64 39:57 40:118 41:61 42:363 43:95 44:64 45:88 46:75 47:32 48:72 49:93 50:137 51:59 52:61 53:43 54:71 55:117 56:87 57:46 58:63 59:26 60:224 61:56 62:66 63:59 64:199 65:187 66:29 67:7
fastp,gen_n1000000_l191_merged.fq,1000000,191,999921,1000000,-79,0.233,0:765932 1:200417 2:26430 3:2252 4:255 5:251 6:109 7:34 8:36 9:20 10:164 11:50 12:40 13:18 14:6 15:119 16:62 17:22 18:10 19:4 20:111 21:42 22:17 23:53 24:41 25:83 26:89 27:32 28:24 29:18 30:103 31:39 32:32 33:21 34:50 35:99 36:79 37:59 38:72 39:54 40:132 41:88 42:329 43:73 44:39 45:95 46:56 47:33 48:76 49:85 50:134 51:69 52:49 53:41 54:67 55:136 56:103 57:50 58:68 59:28 60:206 61:65 62:54 63:55 64:202 65:177 66:127 67:12 68:1 69:1
fastp,gen_n1000000_l192_merged.fq,1000000,192,999907,1000000,-93,0.234,0:763595 1:202152 2:26906 3:2367 4:248 5:237 6:101 7:21 8:45 9:22 10:162 11:67 12:41 13:13 14:4 15:127 16:53 17:20 18:11 19:7 20:141 21:52 22:20 23:52 24:42 25:91 26:86 27:26 28:43 29:22 30:116 31:37 32:41 33:27 34:65 35:80 36:71 37:60 38:41 39:48 40:110 41:47 42:314 43:75 44:56 45:84 46:54 47:33 48:64 49:81 50:131 51:64 52:58 53:48 54:77 55:123 56:76 57:53 58:52 59:36 60:193 61:61 62:80 63:52 64:236 65:203 66:126 67:44 68:7 69:2
fastp,gen_n1000000_l193_merged.fq,1000000,193,999920,1000000,-80,0.236,0:762644 1:203427 2:26628 3:2346 4:250 5:209 6:102 7:20 8:42 9:19 10:134 11:60 12:42 13:13 14:10 15:118 16:55 17:21 18:13 19:4 20:128 21:54 22:22 23:50 24:38 25:89 26:71 27:20 28:32 29:17 30:108 31:46 32:33 33:21 34:20 35:86 36:63 37:50 38:42 39:52 40:131 41:51 42:334 43:72 44:45 45:87 46:57 47:42 48:75 49:82 50:130 51:62 52:58 53:46 54:72 55:151 56:78 57:47 58:51 59:31 60:190 61:73 62:69 63:61 64:199 65:191 66:141 67:52 68:100 69:19 70:3 75:1
fastp,gen_n1000000_l194_merged.fq,1000000,194,999925,1000000,-75,0.236,0:761520 1:203702 2:27167 3:2510 4:303 5:245 6:97 7:18 8:57 9:17 10:151 11:54 12:55 13:10 14:4 15:115 16:79 17:20 18:11 19:6 20:137 21:40 22:11 23:46 24:30 25:89 26:77 27:34 28:34 29:21 30:99 31:43 32:33 33:21 34:35 35:80 36:76 37:52 38:71 39:55 40:124 41:65 42:292 43:90 44:47 45:103 46:57 47:40 48:69 49:104 50:128 51:67 52:52 53:46 54:73 55:116 56:100 57:43 58:41 59:30 60:173 61:56 62:55 63:56 64:215 65:197 66:114 67:31 68:109 69:75 70:7
fastp,gen_n1000000_l195_merged.fq,1000000,195,999921,1000000,-79,0.241,0:759145 1:205485 2:27656 3:2539 4:295 5:217 6:100 7:31 8:68 9:22 10:130 11:44 12:42 13:16 14:6 15:114 16:73 17:22 18:15 19:12 20:133 21:40 22:13 23:47 24:46 25:99 26:69 27:35 28:31 29:28 30:114 31:38 32:35 33:19 34:33 35:52 36:67 37:40 38:51 39:42 40:121 41:63 42:315 43:83 44:53 45:106 46:53 47:29 48:80 49:99 50:134 51:54 52:52 53:34 54:65 55:112 56:103 57:40 58:62 59:29 60:181 61:62 62:59 63:69 64:174 65:141 66:111 67:34 68:82 69:74 70:213 71:44 72:3 73:1 171:1
fastp,gen_n1000000_l196_merged.fq,1000000,196,999940,1000000,-60,0.24,0:757569 1:206543 2:28131 3:2583 4:304 5:228 6:126 7:24 8:45 9:13 10:158 11:52 12:49 13:8 14:8 15:114 16:60 17:20 18:13 19:12 20:130 21:54 22:23 23:40 24:40 25:84 26:84 27:24 28:20 29:14 30:121 31:35 32:34 33:24 34:20 35:63 36:68 37:49 38:61 39:40 40:118 41:50 42:336 43:82 44:47 45:94 46:54 47:33 48:78 49:96 50:133 51:47 52:61 53:38 54:77 55:125 56:100 57:51 58:50 59:25 60:178 61:50 62:65 63:45 64:219 65:108 66:96 67:37 68:67 69:82 70:218 71:48 72:3 73:1
fastp,gen_n1000000_l197_merged.fq,1000000,197,999919,1000000,-81,0.245,0:755100 1:208251 2:28825 3:2611 4:300 5:212 6:85 7:26 8:61 9:26 10:150 11:62 12:39 13:10 14:7 15:115 16:56 17:12 18:10 19:10 20:129 21:39 22:15 23:35 24:47 25:78 26:78 27:38 28:32 29:17 30:112 31:43 32:34 33:22 34:24 35:54 36:52 37:45 38:57 39:53 40:131 41:62 42:304 43:92 44:57 45:96 46:43 47:29 48:63 49:96 50:125 51:49 52:60 53:33 54:70 55:123 56:88 57:52 58:50 59:29 60:182 61:54 62:54 63:44 64:197 65:120 66:119 67:31 68:90 69:57 70:224 71:60 72:129 73:14 74:1
fastp,gen_n1000000_l198_merged.fq,1000000,198,999913,1000000,-87,0.247,0:753857 1:209128 2:29045 3:2650 4:286 5:232 6:113 7:30 8:48 9:27 10:170 11:59 12:47 13:8 14:8 15:125 16:67 17:8 18:17 19:5 20:138 21:38 22:9 23:32 24:41 25:90 26:78 27:35 28:36 29:22 30:92 31:45 32:29 33:20 34:19 35:59 36:42 37:57 38:48 39:44 40:96 41:64 42:331 43:84 44:48 45:110 46:63 47:20 48:57 49:114 50:130 51:53 52:63 53:57 54:58 55:98 56:91 57:45 58:63 59:26 60:190 61:57 62:55 63:57 64:204 65:108 66:78 67:33 68:99 69:62 70:239 71:55 72:146 73:37 74:4 75:1
fastp,gen_n1000000_l199_merged.fq,1000000,199,999921,1000000,-79,0.242,0:751621 1:211025 2:29587 3:2702 4:310 5:235 6:126 7:22 8:58 9:28 10:144 11:41 12:35 13:13 14:15 15:103 16:56 17:15 18:11 19:10 20:116 21:39 22:7 23:51 24:35 25:88 26:72 27:41 28:31 29:20 30:84 31:41 32:26 33:24 34:23 35:58 36:37 37:12 38:57 39:46 40:109 41:48 42:321 43:76 44:40 45:82 46:50 47:26 48:47 49:90 50:133 51:44 52:55 53:31 54:53 55:117 56:83 57:33 58:47 59:29 60:186 61:68 62:58 63:40 64:176 65:104 66:89 67:24 68:91 69:73 70:240 71:57 72:121 73:31 74:53 75:5 76:5
fastp,gen_n1000000_l19_merged.fq,1000000,19,999898,1000000,-102,0.121,0:979655 1:18331 2:1367 3:583 4:60 5:4
fastp,gen_n1000000_l1_merged.fq,1000000,1,999924,0,999924,NA,
fastp,gen_n1000000_l200_merged.fq,1000000,200,999912,1000000,-88,0.248,0:750074 1:211959 2:29797 3:2874 4:332 5:236 6:124 7:23 8:62 9:23 10:160 11:38 12:40 13:17 14:4 15:106 16:55 17:12 18:12 19:4 20:132 21:47 22:17 23:35 24:41 25:77 26:86 27:25 28:41 29:24 30:99 31:30 32:27 33:21 34:15 35:67 36:43 37:34 38:59 39:55 40:126 41:46 42:283 43:89 44:46 45:91 46:66 47:35 48:48 49:96 50:123 51:43 52:64 53:27 54:59 55:96 56:85 57:30 58:69 59:31 60:176 61:52 62:53 63:46 64:194 65:100 66:68 67:31 68:86 69:74 70:143 71:33 72:127 73:39 74:55 75:218 76:23 77:2
fastp,gen_n1000000_l201_merged.fq,1000000,201,999934,1000000,-66,0.249,0:748602 1:212990 2:30200 3:2913 4:345 5:236 6:101 7:19 8:64 9:17 10:158 11:57 12:29 13:7 14:5 15:114 16:56 17:17 18:12 19:11 20:113 21:44 22:18 23:34 24:25 25:75 26:56 27:26 28:32 29:15 30:124 31:48 32:29 33:14 34:27 35:70 36:52 37:28 38:25 39:48 40:117 41:53 42:334 43:87 44:39 45:89 46:49 47:36 48:50 49:69 50:105 51:57 52:53 53:43 54:56 55:113 56:87 57:27 58:59 59:35 60:172 61:73 62:58 63:47 64:201 65:112 66:76 67:24 68:71 69:65 70:140 71:34 72:125 73:27 74:45 75:201 76:101 77:13 78:1
fastp,gen_n1000000_l202_merged.fq,1000000,202,999919,1000000,-81,0.25,0:746296 1:214804 2:30708 3:2882 4:329 5:245 6:106 7:22 8:56 9:26 10:129 11:54 12:40 13:13 14:7 15:119 16:65 17:11 18:17 19:7 20:124 21:39 22:14 23:44 24:37 25:74 26:60 27:26 28:27 29:19 30:103 31:40 32:30 33:20 34:17 35:59 36:45 37:15 38:34 39:44 40:110 41:49 42:330 43:93 44:49 45:81 46:56 47:41 48:49 49:96 50:115 51:55 52:48 53:35 54:70 55:117 56:71 57:30 58:46 59:24 60:152 61:62 62:68 63:48 64:208 65:113 66:78 67:29 68:81 69:69 70:139 71:27 72:123 73:28 74:53 75:209 76:95 77:42 78:4
fastp,gen_n1000000_l203_merged.fq,1000000,203,999910,1000000,-90,0.252,0:744143 1:216181 2:31273 3:3013 4:357 5:245 6:100 7:27 8:55 9:21 10:164 11:47 12:35 13:13 14:12 15:109 16:52 17:17 18:14 19:3 20:141 21:36 22:10 23:51 24:45 25:81 26:79 27:29 28:30 29:17 30:86 31:47 32:24 33:26 34:31 35:62 36:43 37:23 38:14 39:23 40:110 41:50 42:328 43:92 44:47 45:95 46:46 47:32 48:58 49:94 50:107 51:56 52:43 53:38 54:63 55:115 56:75 57:40 58:69 59:24 60:163 61:53 62:50 63:55 64:182 65:100 66:76 67:27 68:92 69:54 70:129 71:43 72:86 73:27 74:61 75:203 76:102 77:21 78:103 79:12
fastp,gen_n1000000_l204_merged.fq,1000000,204,999907,1000000,-93,0.255,0:742491 1:217184 2:31780 3:3153 4:341 5:210 6:104 7:22 8:69 9:12 10:150 11:53 12:38 13:8 14:4 15:93 16:52 17:17 18:17 19:6 20:124 21:51 22:20 23:46 24:32 25:81 26:58 27:32 28:25 29:13 30:116 31:28 32:40 33:18 34:28 35:64 36:39 37:18 38:19 39:21 40:103 41:53 42:329 43:71 44:46 45:96 46:64 47:43 48:58 49:90 50:116 51:55 52:57 53:38 54:52 55:103 56:83 57:36 58:53 59:34 60:163 61:61 62:64 63:53 64:223 65:105 66:83 67:34 68:98 69:65 70:134 71:27 72:99 73:34 74:51 75:181 76:99 77:40 78:99 79:29 80:1
fastp,gen_n1000000_l205_merged.fq,1000000,205,999929,1000000,-71,0.259,0:740100 1:219083 2:32094 3:3160 4:384 5:227 6:91 7:21 8:83 9:12 10:147 11:52 12:36 13:13 14:8 15:118 16:64 17:15 18:13 19:5 20:121 21:48 22:15 23:40 24:45 25:67 26:71 27:33 28:25 29:18 30:121 31:46 32:31 33:18 34:25 35:72 36:47 37:28 38:20 39:14 40:65 41:51 42:309 43:84 44:34 45:98 46:58 47:34 48:48 49:92 50:116 51:60 52:43 53:30 54:62 55:135 56:86 57:37 58:59 59:22 60:170 61:50 62:72 63:48 64:190 65:83 66:83 67:37 68:90 69:51 70:123 71:38 72:104 73:26 74:55 75:123 76:70 77:45 78:92 79:22 80:233 81:37 82:4
fastp,gen_n1000000_l206_merged.fq,1000000,206,999928,1000000,-72,0.258,0:739560 1:219008 2:32621 3:3223 4:424 5:267 6:106 7:20 8:65 9:24 10:142 11:41 12:42 13:14 14:5 15:120 16:50 17:8 18:14 19:6 20:135 21:36 22:20 23:55 24:40 25:74 26:79 27:25 28:31 29:20 30:99 31:36 32:35 33:22 34:28 35:68 36:40 37:23 38:20 39:19 40:108 41:66 42:280 43:77 44:48 45:97 46:40 47:28 48:50 49:92 50:108 51:43 52:50 53:29 54:36 55:101 56:83 57:29 58:59 59:20 60:151 61:48 62:69 63:55 64:213 65:99 66:95 67:26 68:88 69:56 70:146 71:37 72:91 73:27 74:47 75:113 76:75 77:30 78:99 79:35 80:210 81:73 82:7 83:1
fastp,gen_n1000000_l207_merged.fq,1000000,207,999924,1000000,-76,0.261,0:737143 1:220659 2:33132 3:3350 4:416 5:306 6:132 7:36 8:60 9:13 10:140 11:42 12:48 13:16 14:9 15:105 16:58 17:21 18:10 19:7 20:109 21:41 22:18 23:47 24:44 25:72 26:68 27:20 28:31 29:22 30:103 31:36 32:27 33:14 34:21 35:67 36:39 37:28 38:17 39:23 40:108 41:33 42:317 43:77 44:42 45:94 46:46 47:39 48:53 49:95 50:119 51:44 52:35 53:41 54:39 55:133 56:79 57:30 58:52 59:33 60:151 61:59 62:69 63:47 64:226 65:69 66:106 67:30 68:82 69:66 70:135 71:43 72:103 73:26 74:58 75:114 76:67 77:29 78:105 79:34 80:210 81:62 82:46 83:4
fastp,gen_n1000000_l208_merged.fq,1000000,208,999926,1000000,-74,0.262,0:734727 1:222455 2:33549 3:3468 4:428 5:350 6:162 7:38 8:62 9:27 10:153 11:46 12:41 13:11 14:5 15:103 16:53 17:12 18:10 19:10 20:106 21:46 22:11 23:31 24:36 25:84 26:72 27:30 28:29 29:16 30:118 31:38 32:26 33:23 34:30 35:67 36:45 37:28 38:24 39:21 40:70 41:32 42:324 43:77 44:49 45:82 46:50 47:37 48:67 49:102 50:119 51:50 52:38 53:31 54:26 55:124 56:80 57:26 58:62 59:36 60:130 61:59 62:60 63:41 64:199 65:111 66:88 67:30 68:82 69:54 70:128 71:30 72:113 73:38 74:42 75:137 76:79 77:25 78:86 79:26 80:184 81:92 82:57 83:32 84:4
fastp,gen_n1000000_l209_merged.fq,1000000,209,999910,1000000,-90,0.27,0:732229 1:224180 2:34103 3:3426 4:502 5:417 6:185 7:28 8:69 9:31 10:151 11:37 12:41 13:8 14:6 15:104 16:65 17:12 18:15 19:6 20:137 21:34 22:15 23:50 24:51 25:79 26:62 27:34 28:29 29:20 30:103 31:28 32:35 33:19 34:23 35:53 36:43 37:17 38:20 39:31 40:102 41:31 42:168 43:59 44:44 45:97 46:40 47:36 48:55 49:83 50:104 51:55 52:45 53:37 54:44 55:97 56:50 57:39 58:68 59:18 60:153 61:54 62:49 63:50 64:190 65:95 66:77 67:29 68:88 69:54 70:125 71:30 72:78 73:32 74:38 75:100 76:89 77:23 78:81 79:27 80:207 81:82 82:52 83:25 84:360 85:42
fastp,gen_n1000000_l20_merged.fq,1000000,20,999917,1000000,-83,0.119,0:979055 1:19109 2:1091 3:504 4:232 5:3 6:6
fastp,gen_n1000000_l210_merged.fq,1000000,210,999916,1000000,-84,0.279,0:730626 1:225255 2:34185 3:3449 4:483 5:498 6:216 7:49 8:108 9:33 10:155 11:35 12:41 13:12 14:11 15:113 16:60 17:13 18:11 19:7 20:121 21:41 22:12 23:50 24:47 25:83 26:84 27:26 28:35 29:22 30:96 31:42 32:31 33:14 34:26 35:67 36:39 37:19 38:21 39:22 40:84 41:39 42:168 43:61 44:40 45:84 46:63 47:34 48:47 49:101 50:134 51:48 52:40 53:44 54:42 55:121 56:60 57:30 58:58 59:27 60:151 61:38 62:54 63:57 64:224 65:101 66:86 67:22 68:75 69:47 70:125 71:33 72:98 73:26 74:55 75:126 76:78 77:23 78:76 79:28 80:157 81:62 82:44 83:27 84:358 85:219 86:24 87:1 89:2
fastp,gen_n1000000_l211_merged.fq,1000000,211,999931,1000000,-69,0.277,0:727946 1:226725 2:35199 3:3609 4:539 5:520 6:251 7:62 8:96 9:28 10:174 11:47 12:48 13:15 14:5 15:125 16:53 17:19 18:19 19:7 20:133 21:35 22:13 23:44 24:42 25:82 26:64 27:17 28:23 29:16 30:91 31:40 32:40 33:25 34:17 35:58 36:45 37:26 38:18 39:17 40:99 41:43 42:171 43:57 44:39 45:85 46:45 47:30 48:44 49:109 50:110 51:54 52:44 53:39 54:43 55:106 56:46 57:23 58:55 59:28 60:163 61:48 62:42 63:55 64:179 65:99 66:93 67:22 68:75 69:42 70:144 71:28 72:101 73:36 74:54 75:115 76:80 77:33 78:91 79:27 80:131 81:52 82:41 83:22 84:323 85:230 86:69 87:2
fastp,gen_n1000000_l212_merged.fq,1000000,212,999910,1000000,-90,0.279,0:726227 1:227940 2:35403 3:3747 4:572 5:573 6:269 7:53 8:90 9:41 10:232 11:71 12:42 13:12 14:10 15:96 16:72 17:16 18:14 19:4 20:128 21:30 22:17 23:45 24:33 25:82 26:69 27:23 28:33 29:20 30:101 31:31 32:28 33:16 34:18 35:55 36:42 37:23 38:22 39:17 40:93 41:31 42:138 43:51 44:29 45:102 46:54 47:32 48:45 49:84 50:121 51:53 52:34 53:28 54:38 55:101 56:58 57:30 58:25 59:35 60:156 61:54 62:56 63:42 64:194 65:93 66:95 67:34 68:80 69:58 70:128 71:51 72:100 73:27 74:59 75:114 76:84 77:31 78:63 79:26 80:130 81:52 82:35 83:37 84:358 85:224 86:68 87:44 88:6 89:2
fastp,gen_n1000000_l213_merged.fq,1000000,213,999900,1000000,-100,0.278,0:725097 1:228451 2:35783 3:3866 4:590 5:599 6:255 7:68 8:114 9:47 10:280 11:80 12:56 13:18 14:7 15:116 16:55 17:15 18:13 19:5 20:102 21:39 22:13 23:46 24:22 25:67 26:59 27:26 28:32 29:22 30:94 31:37 32:38 33:18 34:25 35:74 36:42 37:36 38:17 39:20 40:107 41:41 42:173 43:45 44:23 45:98 46:52 47:43 48:51 49:95 50:108 51:50 52:39 53:34 54:39 55:119 56:52 57:27 58:33 59:35 60:139 61:47 62:52 63:36 64:188 65:109 66:68 67:31 68:72 69:64 70:124 71:30 72:96 73:28 74:48 75:117 76:90 77:28 78:70 79:22 80:123 81:46 82:42 83:30 84:324 85:193 86:51 87:59 88:58 89:6 90:1
fastp,gen_n1000000_l214_merged.fq,1000000,214,999937,1000000,-63,0.283,0:721829 1:230197 2:36939 3:3982 4:583 5:670 6:279 7:73 8:136 9:52 10:290 11:91 12:56 13:16 14:10 15:95 16:43 17:16 18:11 19:7 20:136 21:35 22:18 23:38 24:43 25:85 26:78 27:17 28:33 29:17 30:117 31:46 32:38 33:21 34:27 35:65 36:46 37:15 38:15 39:22 40:84 41:36 42:167 43:40 44:27 45:77 46:47 47:32 48:59 49:84 50:116 51:51 52:39 53:34 54:50 55:111 56:48 57:35 58:28 59:32 60:155 61:54 62:54 63:51 64:174 65:85 66:74 67:40 68:73 69:62 70:111 71:32 72:87 73:35 74:57 75:109 76:89 77:26 78:87 79:17 80:118 81:59 82:46 83:31 84:382 85:211 86:51 87:64 88:52 89:27 90:3
fastp,gen_n1000000_l215_merged.fq,1000000,215,999920,1000000,-80,0.286,0:720239 1:230924 2:37359 3:4160 4:607 5:715 6:325 7:68 8:161 9:42 10:365 11:102 12:71 13:20 14:15 15:99 16:62 17:15 18:18 19:8 20:132 21:31 22:16 23:30 24:39 25:77 26:79 27:25 28:24 29:21 30:107 31:26 32:30 33:16 34:30 35:55 36:44 37:31 38:16 39:21 40:81 41:34 42:157 43:41 44:26 45:67 46:50 47:28 48:51 49:98 50:104 51:54 52:51 53:37 54:50 55:112 56:61 57:35 58:36 59:25 60:117 61:46 62:55 63:51 64:194 65:107 66:87 67:28 68:66 69:59 70:111 71:29 72:85 73:25 74:52 75:118 76:63 77:25 78:68 79:19 80:119 81:61 82:40 83:21 84:326 85:128 86:51 87:58 88:67 89:29 90:234 91:35 92:3
fastp,gen_n1000000_l216_merged.fq,1000000,216,999907,1000000,-93,0.287,0:718772 1:231845 2:37791 3:4066 4:632 5:778 6:389 7:90 8:141 9:55 10:396 11:115 12:93 13:21 14:16 15:144 16:62 17:15 18:12 19:4 20:117 21:40 22:18 23:50 24:38 25:68 26:61 27:25 28:30 29:14 30:102 31:27 32:29 33:21 34:21 35:63 36:44 37:25 38:23 39:18 40:96 41:27 42:138 43:37 44:19 45:76 46:36 47:35 48:47 49:92 50:101 51:44 52:41 53:39 54:39 55:102 56:35 57:39 58:24 59:22 60:125 61:51 62:56 63:36 64:191 65:95 66:82 67:20 68:78 69:52 70:124 71:33 72:91 73:16 74:42 75:97 76:72 77:27 78:67 79:24 80:137 81:56 82:49 83:22 84:328 85:166 86:46 87:46 88:54 89:22 90:277 91:53 92:5
fastp,gen_n1000000_l217_merged.fq,1000000,217,999922,1000000,-78,0.292,0:715131 1:234085 2:38531 3:4291 4:707 5:798 6:391 7:102 8:162 9:61 10:449 11:138 12:106 13:26 14:23 15:166 16:70 17:10 18:18 19:9 20:132 21:33 22:20 23:43 24:39 25:73 26:72 27:33 28:22 29:14 30:106 31:35 32:32 33:23 34:23 35:47 36:38 37:26 38:16 39:18 40:86 41:41 42:177 43:34 44:25 45:71 46:27 47:29 48:48 49:113 50:90 51:51 52:49 53:31 54:34 55:107 56:57 57:40 58:36 59:26 60:146 61:53 62:67 63:47 64:205 65:87 66:80 67:33 68:76 69:57 70:129 71:39 72:87 73:20 74:49 75:108 76:71 77:30 78:71 79:25 80:126 81:55 82:46 83:17 84:318 85:139 86:56 87:52 88:52 89:29 90:226 91:40 92:64 93:8 94:1
fastp,gen_n1000000_l218_merged.fq,1000000,218,999919,1000000,-81,0.291,0:712727 1:235788 2:39018 3:4365 4:770 5:846 6:407 7:116 8:163 9:75 10:465 11:150 12:102 13:28 14:17 15:220 16:99 17:17 18:14 19:7 20:125 21:39 22:10 23:40 24:37 25:88 26:84 27:16 28:30 29:15 30:106 31:31 32:26 33:25 34:22 35:67 36:41 37:24 38:23 39:18 40:72 41:27 42:163 43:41 44:24 45:73 46:38 47:28 48:57 49:81 50:125 51:57 52:33 53:27 54:55 55:114 56:36 57:23 58:27 59:30 60:109 61:46 62:49 63:35 64:178 65:92 66:87 67:31 68:63 69:38 70:103 71:31 72:95 73:35 74:49 75:114 76:64 77:28 78:79 79:18 80:132 81:46 82:37 83:20 84:319 85:133 86:55 87:57 88:50 89:18 90:250 91:51 92:49 93:44 94:2 100:1
fastp,gen_n1000000_l219_merged.fq,1000000,219,999918,1000000,-82,0.293,0:710971 1:236412 2:39623 3:4564 4:785 5:906 6:451 7:115 8:200 9:72 10:542 11:176 12:136 13:33 14:16 15:257 16:117 17:20 18:11 19:8 20:129 21:31 22:16 23:43 24:30 25:74 26:74 27:25 28:32 29:23 30:100 31:40 32:27 33:17 34:23 35:65 36:31 37:19 38:20 39:20 40:87 41:36 42:140 43:36 44:15 45:57 46:30 47:19 48:57 49:86 50:86 51:50 52:32 53:32 54:37 55:110 56:37 57:33 58:25 59:25 60:127 61:58 62:40 63:40 64:189 65:88 66:66 67:24 68:78 69:55 70:121 71:32 72:84 73:29 74:45 75:120 76:83 77:23 78:68 79:24 80:121 81:50 82:50 83:27 84:356 85:129 86:44 87:35 88:51 89:25 90:221 91:45 92:65 93:50 94:45 95:8
fastp,gen_n1000000_l21_merged.fq,1000000,21,999934,1000000,-66,0.121,0:978295 1:19858 2:899 3:137 4:796 5:15
fastp,gen_n1000000_l220_merged.fq,1000000,220,999916,1000000,-84,0.302,0:708733 1:237963 2:39852 3:4510 4:868 5:951 6:497 7:136 8:232 9:86 10:509 11:169 12:135 13:42 14:23 15:287 16:132 17:27 18:14 19:8 20:108 21:30 22:18 23:45 24:37 25:75 26:72 27:23 28:35 29:16 30:91 31:38 32:28 33:15 34:17 35:49 36:40 37:28 38:30 39:22 40:96 41:33 42:164 43:41 44:25 45:84 46:32 47:16 48:57 49:91 50:117 51:44 52:53 53:26 54:35 55:116 56:49 57:29 58:25 59:21 60:111 61:52 62:34 63:38 64:177 65:111 66:86 67:25 68:88 69:45 70:121 71:39 72:100 73:25 74:53 75:98 76:80 77:22 78:71 79:19 80:142 81:51 82:35 83:27 84:332 85:142 86:65 87:54 88:48 89:21 90:163 91:32 92:51 93:53 94:43 95:172 96:28 97:1
fastp,gen_n1000000_l221_merged.fq,1000000,221,999924,1000000,-76,0.305,0:705888 1:239644 2:40525 3:4762 4:876 5:1028 6:492 7:144 8:218 9:79 10:595 11:195 12:144 13:40 14:27 15:296 16:129 17:38 18:24 19:6 20:151 21:48 22:22 23:48 24:36 25:73 26:68 27:36 28:22 29:14 30:88 31:28 32:33 33:13 34:22 35:56 36:31 37:23 38:20 39:10 40:99 41:33 42:143 43:37 44:27 45:57 46:29 47:17 48:40 49:119 50:128 51:53 52:40 53:24 54:40 55:122 56:50 57:29 58:30 59:29 60:123 61:57 62:35 63:47 64:134 65:86 66:77 67:24 68:77 69:47 70:124 71:31 72:62 73:21 74:53 75:124 76:60 77:38 78:49 79:16 80:112 81:59 82:33 83:21 84:331 85:153 86:44 87:48 88:50 89:25 90:160 91:38 92:53 93:54 94:47 95:178 96:147 97:24
fastp,gen_n1000000_l222_merged.fq,1000000,222,999924,1000000,-76,0.309,0:703501 1:240626 2:41091 3:4952 4:930 5:1175 6:616 7:133 8:222 9:94 10:631 11:236 12:154 13:42 14:37 15:350 16:152 17:39 18:23 19:9 20:176 21:44 22:15 23:57 24:53 25:61 26:73 27:27 28:44 29:15 30:112 31:34 32:34 33:19 34:26 35:58 36:35 37:31 38:18 39:24 40:88 41:30 42:167 43:42 44:27 45:71 46:32 47:13 48:30 49:90 50:132 51:50 52:37 53:35 54:39 55:104 56:49 57:38 58:30 59:19 60:132 61:48 62:35 63:50 64:169 65:100 66:71 67:29 68:80 69:42 70:125 71:27 72:67 73:26 74:51 75:109 76:59 77:33 78:77 79:18 80:127 81:63 82:47 83:18 84:285 85:151 86:49 87:49 88:50 89:22 90:150 91:36 92:52 93:64 94:39 95:177 96:149 97:27 98:4 102:1
fastp,gen_n1000000_l223_merged.fq,1000000,223,999932,1000000,-68,0.314,0:700307 1:242248 2:42119 3:5014 4:1005 5:1252 6:609 7:200 8:254 9:121 10:674 11:241 12:161 13:54 14:43 15:429 16:186 17:48 18:28 19:19 20:194 21:67 22:17 23:54 24:33 25:67 26:76 27:30 28:29 29:17 30:94 31:31 32:25 33:22 34:19 35:60 36:36 37:18 38:26 39:23 40:88 41:46 42:163 43:43 44:21 45:68 46:25 47:14 48:35 49:66 50:99 51:48 52:26 53:31 54:32 55:101 56:54 57:39 58:22 59:29 60:107 61:57 62:39 63:52 64:148 65:95 66:79 67:36 68:69 69:58 70:117 71:39 72:76 73:26 74:48 75:97 76:61 77:25 78:72 79:19 80:132 81:56 82:37 83:15 84:339 85:146 86:49 87:53 88:45 89:16 90:157 91:50 92:45 93:54 94:49 95:156 96:159 97:21 98:92 99:8 101:1
fastp,gen_n1000000_l224_merged.fq,1000000,224,999922,1000000,-78,0.315,0:698679 1:243192 2:42254 3:5167 4:1039 5:1361 6:680 7:206 8:263 9:128 10:736 11:242 12:191 13:53 14:42 15:403 16:186 17:37 18:44 19:15 20:233 21:88 22:21 23:46 24:33 25:77 26:94 27:23 28:22 29:18 30:119 31:34 32:26 33:21 34:19 35:59 36:35 37:18 38:18 39:21 40:101 41:23 42:174 43:39 44:28 45:48 46:33 47:11 48:41 49:55 50:114 51:40 52:44 53:37 54:42 55:113 56:46 57:32 58:22 59:25 60:123 61:55 62:40 63:43 64:174 65:98 66:43 67:20 68:76 69:54 70:108 71:25 72:64 73:26 74:55 75:110 76:78 77:27 78:67 79:18 80:121 81:51 82:50 83:17 84:356 85:128 86:46 87:45 88:50 89:21 90:181 91:27 92:47 93:49 94:31 95:150 96:124 97:38 98:91 99:56 100:5 101:1
fastp,gen_n1000000_l225_merged.fq,1000000,225,999911,1000000,-89,0.324,0:694379 1:245550 2:43278 3:5309 4:1184 5:1523 6:779 7:198 8:262 9:126 10:786 11:266 12:211 13:67 14:47 15:457 16:234 17:50 18:40 19:13 20:290 21:85 22:41 23:44 24:47 25:81 26:77 27:21 28:29 29:18 30:95 31:38 32:19 33:16 34:20 35:55 36:41 37:16 38:17 39:11 40:92 41:31 42:161 43:50 44:27 45:64 46:27 47:16 48:39 49:56 50:105 51:49 52:42 53:30 54:32 55:95 56:56 57:21 58:27 59:24 60:121 61:41 62:37 63:48 64:166 65:88 66:54 67:39 68:72 69:45 70:113 71:33 72:70 73:24 74:47 75:90 76:64 77:22 78:89 79:30 80:123 81:57 82:37 83:28 84:342 85:135 86:48 87:42 88:52 89:15 90:160 91:29 92:42 93:48 94:53 95:88 96:106 97:34 98:93 99:69 100:214 101:26 102:2
fastp,gen_n1000000_l226_merged.fq,1000000,226,999920,1000000,-80,0.326,0:692347 1:246220 2:43862 3:5533 4:1295 5:1542 6:854 7:238 8:328 9:178 10:808 11:294 12:199 13:62 14:63 15:523 16:239 17:59 18:59 19:14 20:295 21:98 22:24 23:58 24:50 25:101 26:82 27:31 28:26 29:12 30:98 31:31 32:31 33:18 34:18 35:58 36:28 37:24 38:19 39:15 40:89 41:29 42:173 43:42 44:22 45:69 46:27 47:15 48:29 49:59 50:85 51:43 52:39 53:24 54:50 55:112 56:56 57:24 58:28 59:18 60:107 61:53 62:32 63:45 64:170 65:84 66:57 67:23 68:75 69:57 70:132 71:38 72:63 73:28 74:54 75:103 76:71 77:24 78:81 79:12 80:109 81:46 82:33 83:31 84:329 85:123 86:43 87:46 88:44 89:19 90:158 91:32 92:54 93:45 94:40 95:102 96:135 97:21 98:73 99:62 100:230 101:42 102:6 104:1
fastp,gen_n1000000_l227_merged.fq,1000000,227,999921,999999,-78,0.332,0:689975 1:246731 2:44761 3:5703 4:1377 5:1672 6:926 7:277 8:365 9:153 10:902 11:320 12:220 13:70 14:73 15:586 16:284 17:60 18:55 19:19 20:382 21:118 22:42 23:73 24:57 25:100 26:83 27:32 28:23 29:17 30:85 31:35 32:27 33:22 34:25 35:64 36:46 37:27 38:20 39:22 40:102 41:29 42:160 43:47 44:20 45:88 46:21 47:17 48:36 49:64 50:104 51:25 52:32 53:32 54:43 55:93 56:50 57:31 58:23 59:29 60:97 61:52 62:33 63:34 64:138 65:93 66:53 67:19 68:38 69:49 70:118 71:36 72:64 73:36 74:53 75:98 76:60 77:26 78:70 79:13 80:107 81:42 82:43 83:24 84:320 85:135 86:61 87:46 88:55 89:23 90:158 91:28 92:43 93:42 94:41 95:103 96:105 97:26 98:88 99:59 100:218 101:54 102:118 103:5
fastp,gen_n1000000_l228_merged.fq,1000000,228,999925,999997,-72,0.336,0:686133 1:248992 2:45558 3:5782 4:1510 5:1871 6:992 7:310 8:434 9:195 10:950 11:343 12:247 13:77 14:84 15:590 16:296 17:69 18:53 19:29 20:377 21:129 22:31 23:74 24:55 25:141 26:118 27:27 28:28 29:9 30:85 31:26 32:22 33:22 34:17 35:57 36:41 37:16 38:17 39:15 40:71 41:35 42:148 43:34 44:20 45:74 46:27 47:14 48:38 49:54 50:80 51:33 52:39 53:32 54:42 55:110 56:51 57:39 58:15 59:20 60:124 61:58 62:29 63:36 64:165 65:84 66:49 67:22 68:37 69:46 70:113 71:34 72:64 73:17 74:43 75:90 76:63 77:28 78:57 79:25 80:112 81:41 82:52 83:34 84:293 85:140 86:55 87:58 88:56 89:21 90:157 91:41 92:49 93:47 94:52 95:119 96:106 97:23 98:97 99:59 100:230 101:37 102:112 103:22 104:2
fastp,gen_n1000000_l229_merged.fq,1000000,229,999915,999987,-72,0.338,0:684414 1:249511 2:46073 3:5907 4:1447 5:1893 6:1059 7:358 8:453 9:176 10:1043 11:399 12:266 13:98 14:89 15:693 16:332 17:67 18:71 19:23 20:428 21:120 22:45 23:84 24:70 25:167 26:122 27:43 28:29 29:16 30:100 31:23 32:25 33:18 34:19 35:68 36:45 37:22 38:14 39:20 40:86 41:32 42:131 43:46 44:27 45:65 46:24 47:11 48:33 49:49 50:104 51:35 52:18 53:31 54:40 55:88 56:56 57:26 58:25 59:20 60:112 61:48 62:43 63:41 64:166 65:90 66:55 67:16 68:55 69:36 70:117 71:46 72:70 73:24 74:41 75:78 76:67 77:29 78:69 79:20 80:103 81:45 82:47 83:24 84:298 85:124 86:55 87:46 88:48 89:15 90:153 91:42 92:50 93:53 94:47 95:121 96:101 97:22 98:88 99:64 100:197 101:31 102:107 103:27 104:52 105:7
fastp,gen_n1000000_l22_merged.fq,1000000,22,999918,1000000,-82,0.118,0:977705 1:20484 2:720 3:352 4:735 5:4
fastp,gen_n1000000_l230_merged.fq,1000000,230,999909,999952,-43,0.348,0:681736 1:251086 2:46677 3:5938 4:1213 5:1925 6:1115 7:387 8:480 9:217 10:1122 11:418 12:296 13:84 14:100 15:727 16:363 17:84 18:60 19:31 20:460 21:132 22:47 23:109 24:80 25:193 26:149 27:39 28:30 29:13 30:97 31:34 32:32 33:17 34:20 35:56 36:32 37:17 38:23 39:15 40:76 41:35 42:125 43:47 44:25 45:70 46:25 47:19 48:37 49:59 50:94 51:20 52:24 53:28 54:40 55:126 56:48 57:21 58:20 59:31 60:106 61:50 62:38 63:40 64:161 65:95 66:38 67:32 68:42 69:46 70:96 71:26 72:80 73:25 74:35 75:109 76:58 77:37 78:49 79:35 80:99 81:56 82:39 83:21 84:331 85:123 86:51 87:47 88:39 89:18 90:175 91:37 92:52 93:35 94:40 95:96 96:104 97:30 98:69 99:72 100:154 101:34 102:106 103:23 104:54 105:202 106:22 109:1
fastp,gen_n1000000_l231_merged.fq,1000000,231,999908,999846,62,0.348,0:678582 1:253542 2:47146 3:6338 4:1355 5:1299 6:919 7:391 8:554 9:252 10:1111 11:474 12:320 13:128 14:113 15:835 16:364 17:83 18:83 19:34 20:427 21:153 22:65 23:78 24:82 25:245 26:192 27:44 28:46 29:20 30:99 31:42 32:26 33:18 34:19 35:56 36:30 37:11 38:12 39:12 40:84 41:36 42:147 43:48 44:24 45:72 46:24 47:14 48:38 49:66 50:93 51:29 52:27 53:15 54:36 55:83 56:57 57:22 58:26 59:21 60:116 61:44 62:34 63:39 64:165 65:94 66:42 67:22 68:47 69:41 70:88 71:38 72:63 73:23 74:48 75:92 76:64 77:28 78:51 79:17 80:101 81:48 82:54 83:24 84:326 85:129 86:41 87:42 88:51 89:29 90:141 91:24 92:47 93:33 94:44 95:94 96:135 97:18 98:81 99:67 100:128 101:35 102:100 103:20 104:54 105:201 106:54 107:5 184:1 220:1
fastp,gen_n1000000_l232_merged.fq,1000000,232,999927,999548,379,0.354,0:675623 1:254130 2:48085 3:6499 4:1598 5:1494 6:735 7:308 8:584 9:310 10:1336 11:521 12:373 13:123 14:123 15:846 16:430 17:124 18:76 19:29 20:555 21:177 22:53 23:99 24:89 25:239 26:189 27:54 28:50 29:22 30:132 31:34 32:37 33:25 34:17 35:55 36:32 37:19 38:14 39:20 40:100 41:34 42:178 43:50 44:21 45:61 46:16 47:15 48:33 49:61 50:96 51:28 52:21 53:11 54:40 55:123 56:50 57:30 58:31 59:23 60:124 61:40 62:35 63:42 64:154 65:103 66:48 67:17 68:33 69:54 70:102 71:31 72:51 73:28 74:42 75:95 76:74 77:30 78:38 79:30 80:113 81:49 82:40 83:20 84:310 85:137 86:34 87:37 88:47 89:19 90:139 91:37 92:41 93:46 94:52 95:88 96:109 97:31 98:72 99:47 100:146 101:35 102:104 103:22 104:64 105:189 106:47 107:15 108:1 109:1 172:1 198:1 201:1 217:1
fastp,gen_n1000000_l233_merged.fq,1000000,233,999907,999573,334,0.365,0:672700 1:255550 2:48375 3:6605 4:1730 5:1678 6:877 7:273 8:576 9:362 10:1449 11:557 12:428 13:160 14:127 15:891 16:489 17:144 18:103 19:46 20:539 21:208 22:67 23:111 24:103 25:224 26:215 27:72 28:58 29:21 30:168 31:39 32:31 33:18 34:12 35:64 36:30 37:23 38:18 39:21 40:89 41:37 42:172 43:31 44:26 45:77 46:41 47:11 48:24 49:55 50:90 51:28 52:27 53:9 54:18 55:97 56:42 57:35 58:26 59:18 60:100 61:44 62:40 63:50 64:165 65:115 66:45 67:40 68:48 69:39 70:108 71:29 72:39 73:16 74:59 75:104 76:69 77:31 78:50 79:15 80:111 81:39 82:33 83:16 84:319 85:126 86:47 87:40 88:43 89:22 90:152 91:38 92:55 93:42 94:46 95:102 96:112 97:24 98:79 99:56 100:143 101:41 102:88 103:24 104:55 105:191 106:66 107:15 108:116 109:5 140:1 173:1 205:1 206:1 212:1 220:1
fastp,gen_n1000000_l234_merged.fq,1000000,234,999922,999346,576,0.367,0:668918 1:257092 2:49608 3:6602 4:1894 5:1778 6:1098 7:423 8:370 9:278 10:1476 11:589 12:470 13:174 14:137 15:1033 16:514 17:127 18:127 19:54 20:599 21:205 22:78 23:140 24:116 25:275 26:234 27:67 28:48 29:29 30:168 31:51 32:37 33:21 34:21 35:62 36:33 37:16 38:20 39:18 40:88 41:41 42:169 43:44 44:24 45:66 46:39 47:14 48:25 49:70 50:93 51:29 52:24 53:11 54:38 55:102 56:43 57:19 58:32 59:26 60:110 61:46 62:47 63:40 64:136 65:99 66:47 67:36 68:38 69:50 70:104 71:28 72:47 73:18 74:36 75:90 76:59 77:20 78:53 79:26 80:113 81:32 82:41 83:28 84:305 85:135 86:42 87:50 88:50 89:16 90:145 91:29 92:50 93:39 94:49 95:93 96:96 97:18 98:77 99:50 100:146 101:31 102:91 103:17 104:46 105:197 106:69 107:24 108:106 109:26 110:3 111:1 199:1 217:1 223:2
fastp,gen_n1000000_l235_merged.fq,1000000,235,999915,997789,2126,0.376,0:665754 1:257265 2:50168 3:6999 4:1409 5:1749 6:1187 7:485 8:507 9:227 10:1642 11:697 12:475 13:214 14:187 15:1043 16:573 17:152 18:136 19:64 20:688 21:217 22:85 23:140 24:109 25:328 26:233 27:71 28:52 29:22 30:208 31:60 32:49 33:18 34:20 35:40 36:36 37:19 38:16 39:9 40:76 41:34 42:149 43:37 44:28 45:70 46:28 47:15 48:30 49:78 50:96 51:27 52:19 53:14 54:24 55:98 56:42 57:34 58:27 59:21 60:106 61:35 62:42 63:30 64:156 65:93 66:57 67:27 68:45 69:40 70:109 71:25 72:41 73:26 74:48 75:105 76:76 77:25 78:51 79:20 80:110 81:35 82:43 83:24 84:291 85:129 86:43 87:43 88:46 89:24 90:152 91:35 92:51 93:43 94:41 95:92 96:105 97:39 98:83 99:47 100:136 101:22 102:84 103:33 104:49 105:130 106:63 107:18 108:117 109:23 110:153 111:15 119:1 158:1 205:4 213:1 215:1 216:1 224:4
fastp,gen_n1000000_l236_merged.fq,1000000,236,999917,997692,2225,0.382,0:662049 1:259579 2:51463 3:7277 4:1620 5:1452 6:1147 7:526 8:632 9:334 10:949 11:425 12:502 13:203 14:191 15:1160 16:557 17:173 18:139 19:54 20:683 21:256 22:96 23:171 24:156 25:363 26:292 27:85 28:61 29:31 30:217 31:85 32:45 33:38 34:18 35:65 36:36 37:27 38:12 39:17 40:88 41:27 42:158 43:47 44:30 45:84 46:28 47:11 48:35 49:64 50:96 51:26 52:27 53:12 54:22 55:87 56:54 57:27 58:24 59:28 60:109 61:56 62:32 63:41 64:149 65:101 66:44 67:28 68:47 69:49 70:89 71:32 72:35 73:20 74:29 75:65 76:74 77:14 78:56 79:17 80:110 81:44 82:40 83:12 84:300 85:121 86:37 87:45 88:54 89:33 90:151 91:38 92:48 93:40 94:41 95:90 96:105 97:25 98:98 99:68 100:143 101:41 102:101 103:27 104:47 105:128 106:52 107:21 108:116 109:30 110:161 111:57 112:8 132:1 208:1 209:1 214:1 216:1 218:1 219:1 222:1 224:3 225:1
fastp,gen_n1000000_l237_merged.fq,1000000,237,999921,997672,2249,0.388,0:658966 1:259902 2:52327 3:7885 4:2062 5:1763 6:856 7:454 8:733 9:437 10:1036 11:407 12:478 13:226 14:223 15:1263 16:657 17:192 18:151 19:76 20:824 21:303 22:97 23:165 24:166 25:389 26:331 27:102 28:64 29:31 30:272 31:84 32:48 33:34 34:23 35:83 36:48 37:23 38:26 39:12 40:81 41:32 42:176 43:41 44:23 45:52 46:19 47:11 48:42 49:80 50:93 51:31 52:23 53:17 54:26 55:104 56:32 57:27 58:28 59:25 60:126 61:47 62:31 63:42 64:157 65:85 66:44 67:23 68:47 69:46 70:86 71:16 72:32 73:28 74:22 75:91 76:63 77:24 78:40 79:21 80:119 81:45 82:42 83:23 84:287 85:139 86:37 87:41 88:35 89:17 90:140 91:33 92:46 93:52 94:44 95:94 96:117 97:15 98:74 99:53 100:144 101:37 102:73 103:16 104:58 105:113 106:53 107:26 108:120 109:18 110:166 111:64 112:60 121:1 136:1 141:1 143:1 171:1 204:1 205:1 210:2 212:1 213:2 215:1 217:1 219:1 220:1 223:1 224:1
fastp,gen_n1000000_l238_merged.fq,1000000,238,999925,997648,2277,0.393,0:656222 1:261703 2:52070 3:7803 4:2092 5:1989 6:1135 7:386 8:853 9:476 10:1267 11:503 12:336 13:172 14:214 15:1397 16:767 17:201 18:184 19:103 20:819 21:336 22:119 23:178 24:155 25:419 26:365 27:126 28:74 29:38 30:278 31:74 32:61 33:42 34:28 35:102 36:58 37:20 38:14 39:16 40:88 41:41 42:151 43:44 44:19 45:59 46:35 47:5 48:34 49:53 50:90 51:32 52:25 53:12 54:26 55:88 56:34 57:29 58:25 59:23 60:114 61:54 62:30 63:44 64:151 65:96 66:43 67:20 68:41 69:48 70:101 71:31 72:37 73:16 74:29 75:84 76:73 77:26 78:51 79:27 80:111 81:37 82:58 83:17 84:301 85:127 86:41 87:47 88:42 89:25 90:150 91:26 92:56 93:43 94:44 95:107 96:93 97:29 98:79 99:49 100:111 101:30 102:101 103:17 104:48 105:114 106:53 107:20 108:106 109:23 110:170 111:54 112:65 113:18 114:2 185:1 200:1 215:1 218:1 223:2 224:2 226:1 227:1
fastp,gen_n1000000_l239_merged.fq,1000000,239,999926,997778,2148,0.403,0:652744 1:262409 2:53455 3:7674 4:2470 5:2279 6:1447 7:578 8:503 9:396 10:1373 11:580 12:368 13:143 14:256 15:1546 16:835 17:210 18:208 19:77 20:926 21:346 22:133 23:218 24:221 25:493 26:419 27:113 28:100 29:28 30:309 31:113 32:58 33:32 34:22 35:104 36:56 37:23 38:15 39:21 40:86 41:42 42:155 43:36 44:16 45:75 46:35 47:13 48:26 49:62 50:100 51:24 52:27 53:15 54:20 55:86 56:34 57:9 58:25 59:29 60:112 61:44 62:39 63:48 64:158 65:101 66:39 67:26 68:44 69:53 70:80 71:27 72:45 73:20 74:30 75:86 76:40 77:24 78:49 79:23 80:122 81:38 82:42 83:18 84:269 85:123 86:41 87:44 88:46 89:20 90:130 91:25 92:42 93:32 94:42 95:96 96:111 97:26 98:76 99:49 100:146 101:28 102:103 103:16 104:41 105:117 106:49 107:16 108:96 109:26 110:154 111:66 112:83 113:11 114:110 115:6 116:1 134:1 136:1 137:1 171:1 205:2 210:1 221:1 224:1 225:1 226:1 227:1 228:1
fastp,gen_n1000000_l23_merged.fq,1000000,23,999913,1000000,-87,0.118,0:976555 1:21308 2:1239 3:305 4:591 5:2
fastp,gen_n1000000_l240_merged.fq,1000000,240,999921,37272,962649,33.758,1:1291 2:1819 3:1203 4:1027 5:2096 6:1653 7:805 8:629 9:297 10:1362 11:658 12:482 13:236 14:149 15:1636 16:871 17:290 18:251 19:90 20:967 21:338 22:136 23:261 24:201 25:517 26:438 27:132 28:91 29:55 30:364 31:90 32:64 33:46 34:26 35:123 36:67 37:26 38:20 39:12 40:84 41:31 42:157 43:50 44:35 45:61 46:25 47:15 48:40 49:48 50:90 51:34 52:29 53:13 54:16 55:97 56:33 57:8 58:28 59:16 60:112 61:40 62:52 63:40 64:148 65:89 66:42 67:26 68:41 69:49 70:77 71:30 72:38 73:10 74:28 75:89 76:33 77:23 78:61 79:23 80:112 81:33 82:38 83:25 84:287 85:124 86:61 87:39 88:57 89:18 90:148 91:23 92:44 93:44 94:44 95:97 96:90 97:17 98:86 99:54 100:140 101:45 102:81 103:17 104:66 105:122 106:54 107:13 108:95 109:13 110:111 111:56 112:81 113:12 114:82 115:156 116:27 117:11 118:7 119:27 120:43 121:24 122:4 123:4 124:44 125:64 126:209 127:42 128:17 129:13 130:34 131:8 132:13 133:8 134:18 135:38 136:18 137:18 138:14 139:10 140:19 141:6 142:10 143:5 144:30 145:31 146:11 147:54 148:6 149:4 150:32 151:5 152:5 153:11 154:10 155:28 156:8 157:6 158:7 159:14 160:77 161:8 162:17 163:48 164:23 165:48 166:9 167:76 168:225 169:50 170:155 171:262 172:74 173:11 174:87 175:108 176:22 177:15 178:18 179:24 180:55 181:2 182:25 183:8 184:18 185:42 186:2 187:5 188:8 189:19 190:29 191:8 192:11 193:10 194:18 195:55 196:25 197:10 198:34 199:20 200:112 201:19 202:77 203:41 204:117 205:394 206:42 207:67 208:81 209:339 210:1516 211:63 212:70 213:81 214:246 215:725 216:132 217:102 218:354 219:752 220:491 221:130 222:277 223:65 224:532 225:752 226:104 227:393 228:361 229:694
fastp,gen_n1000000_l241_merged.fq,1000000,241,999922,36549,963373,35.495,2:1761 3:1479 4:1473 5:1789 6:1684 7:915 8:903 9:441 10:1011 11:523 12:579 13:247 14:168 15:893 16:616 17:233 18:247 19:122 20:1142 21:398 22:138 23:317 24:226 25:576 26:472 27:165 28:108 29:45 30:396 31:135 32:74 33:32 34:35 35:126 36:73 37:30 38:20 39:15 40:92 41:36 42:162 43:36 44:19 45:69 46:23 47:13 48:47 49:60 50:105 51:32 52:27 53:16 54:28 55:97 56:31 57:12 58:21 59:24 60:118 61:44 62:33 63:41 64:174 65:87 66:56 67:24 68:48 69:54 70:75 71:20 72:34 73:23 74:26 75:84 76:45 77:25 78:54 79:17 80:104 81:32 82:36 83:28 84:265 85:129 86:44 87:25 88:48 89:16 90:140 91:31 92:41 93:46 94:40 95:93 96:96 97:26 98:71 99:49 100:139 101:30 102:93 103:13 104:60 105:111 106:55 107:17 108:92 109:23 110:106 111:30 112:71 113:20 114:92 115:151 116:71 117:9 118:6 119:27 120:38 121:28 122:10 123:8 124:36 125:60 126:234 127:42 128:11 129:20 130:40 131:11 132:3 133:11 134:25 135:54 136:24 137:22 138:12 139:7 140:34 141:3 142:7 143:8 144:26 145:30 146:9 147:50 148:5 149:13 150:39 151:5 152:9 153:7 154:7 155:40 156:10 157:7 158:10 159:11 160:67 161:7 162:9 163:53 164:13 165:59 166:12 167:90 168:227 169:38 170:179 171:229 172:69 173:12 174:103 175:125 176:11 177:11 178:9 179:26 180:49 181:4 182:41 183:9 184:16 185:44 188:13 189:19 190:43 191:4 192:11 193:19 194:10 195:59 196:20 197:3 198:26 199:40 200:103 201:23 202:62 203:41 204:93 205:335 206:47 207:63 208:59 209:337 210:1507 211:46 212:57 213:70 214:228 215:735 216:231 217:77 218:285 219:775 220:517 221:182 222:263 223:63 224:429 225:671 226:200 227:312 228:219 229:517 230:982
fastp,gen_n1000000_l242_merged.fq,1000000,242,999910,35341,964569,35.114,3:1106 4:1952 5:2287 6:1142 7:763 8:1007 9:644 10:1164 11:517 12:674 13:348 14:273 15:1109 16:488 17:214 18:272 19:133 20:1118 21:481 22:173 23:338 24:254 25:649 26:547 27:158 28:116 29:61 30:428 31:152 32:85 33:32 34:31 35:147 36:75 37:32 38:19 39:20 40:129 41:38 42:166 43:52 44:19 45:78 46:32 47:14 48:34 49:57 50:107 51:26 52:25 53:19 54:24 55:103 56:47 57:9 58:21 59:20 60:107 61:51 62:40 63:29 64:150 65:98 66:45 67:22 68:38 69:36 70:105 71:30 72:35 73:18 74:21 75:109 76:44 77:28 78:36 79:17 80:95 81:31 82:36 83:18 84:266 85:121 86:45 87:32 88:38 89:23 90:162 91:32 92:50 93:40 94:42 95:84 96:87 97:14 98:93 99:58 100:139 101:38 102:77 103:25 104:62 105:123 106:47 107:13 108:75 109:24 110:95 111:38 112:74 113:16 114:77 115:154 116:69 117:47 118:11 119:14 120:27 121:16 122:8 123:6 124:37 125:56 126:267 127:34 128:16 129:17 130:39 131:9 132:9 133:12 134:16 135:51 136:34 137:12 138:14 139:7 140:46 141:10 142:8 143:6 144:28 145:24 146:8 147:61 148:11 149:10 150:29 151:1 152:7 153:8 154:11 155:35 156:12 157:6 158:12 159:12 160:90 161:7 162:7 163:63 164:19 165:47 166:17 167:74 168:254 169:34 170:153 171:261 172:56 173:12 174:113 175:107 176:11 177:10 178:9 179:40 180:51 181:6 182:38 183:9 184:11 185:39 186:2 187:3 188:8 189:14 190:35 191:1 192:12 193:13 194:12 195:40 196:21 197:5 198:31 199:25 200:93 201:18 202:54 203:39 204:63 205:300 206:59 207:50 208:50 209:284 210:1426 211:36 212:47 213:64 214:188 215:561 216:166 217:108 218:257 219:690 220:423 221:180 222:345 223:58 224:407 225:560 226:165 227:478 228:138 229:346 230:610 231:613
fastp,gen_n1000000_l243_merged.fq,1000000,243,999926,35186,964740,33.222,4:1867 5:2695 6:1600 7:550 8:1264 9:782 10:1565 11:628 12:397 13:263 14:296 15:1117 16:607 17:196 18:287 19:134 20:1248 21:472 22:181 23:421 24:304 25:711 26:708 27:180 28:123 29:72 30:516 31:139 32:77 33:40 34:40 35:152 36:102 37:34 38:23 39:20 40:107 41:43 42:171 43:51 44:22 45:65 46:27 47:6 48:31 49:56 50:101 51:18 52:24 53:9 54:22 55:83 56:40 57:18 58:20 59:15 60:122 61:57 62:32 63:43 64:159 65:87 66:57 67:20 68:46 69:45 70:97 71:35 72:45 73:25 74:22 75:90 76:27 77:23 78:27 79:20 80:91 81:35 82:33 83:21 84:293 85:108 86:52 87:29 88:23 89:20 90:158 91:37 92:43 93:41 94:32 95:86 96:97 97:25 98:88 99:42 100:148 101:25 102:95 103:17 104:48 105:120 106:41 107:12 108:80 109:11 110:95 111:52 112:71 113:12 114:89 115:148 116:73 117:57 118:30 119:28 120:38 121:10 122:7 123:2 124:30 125:54 126:236 127:41 128:15 129:16 130:36 131:9 132:7 133:10 134:18 135:42 136:24 137:20 138:14 139:5 140:21 141:10 142:9 143:2 144:27 145:23 146:7 147:40 148:8 149:10 150:40 151:7 152:4 153:8 154:16 155:48 156:11 157:7 158:13 159:10 160:55 161:8 162:5 163:55 164:18 165:45 166:8 167:68 168:236 169:35 170:142 171:266 172:71 173:10 174:85 175:101 176:27 177:15 178:11 179:30 180:63 181:3 182:35 183:7 184:20 185:47 186:2 187:4 188:8 189:12 190:37 191:2 192:12 193:14 194:14 195:33 196:26 197:4 198:24 199:18 200:83 201:12 202:55 203:21 204:56 205:252 206:30 207:49 208:52 209:262 210:1282 211:32 212:34 213:46 214:169 215:508 216:155 217:103 218:359 219:551 220:397 221:156 222:334 223:81 224:325 225:451 226:102 227:390 228:243 229:273 230:458 231:349 232:460
fastp,gen_n1000000_l244_merged.fq,1000000,244,999921,34113,965808,33.48,5:2388 6:2123 7:1017 8:689 9:706 10:1680 11:781 12:506 13:206 14:333 15:1290 16:759 17:247 18:190 19:106 20:1362 21:510 22:207 23:465 24:324 25:785 26:682 27:238 28:127 29:54 30:523 31:170 32:111 33:43 34:38 35:172 36:110 37:43 38:34 39:23 40:123 41:44 42:195 43:66 44:31 45:65 46:23 47:12 48:23 49:60 50:98 51:33 52:31 53:12 54:22 55:103 56:32 57:20 58:20 59:15 60:117 61:48 62:22 63:30 64:143 65:88 66:54 67:23 68:38 69:46 70:97 71:26 72:37 73:22 74:28 75:82 76:35 77:31 78:30 79:11 80:108 81:40 82:40 83:19 84:300 85:141 86:46 87:25 88:34 89:14 90:137 91:31 92:37 93:42 94:31 95:82 96:90 97:24 98:87 99:46 100:140 101:30 102:68 103:9 104:44 105:115 106:46 107:15 108:91 109:16 110:88 111:45 112:61 113:12 114:93 115:129 116:84 117:54 118:35 119:41 120:32 121:21 122:11 123:6 124:26 125:51 126:229 127:42 128:14 129:18 130:31 131:6 132:10 133:15 134:12 135:45 136:30 137:12 138:21 139:6 140:20 141:7 142:15 143:4 144:29 145:25 146:11 147:29 148:9 149:5 150:29 151:2 152:3 153:4 154:11 155:29 156:11 157:6 158:9 159:9 160:67 161:7 162:7 163:71 164:20 165:49 166:14 167:85 168:255 169:42 170:137 171:248 172:62 173:8 174:95 175:106 176:14 177:11 178:12 179:25 180:55 181:6 182:31 183:7 184:16 185:37 186:3 187:1 188:7 189:11 190:30 191:7 192:11 193:11 194:11 195:30 196:17 197:4 198:15 199:15 200:68 201:9 202:45 203:15 204:52 205:214 206:41 207:39 208:42 209:244 210:1174 211:35 212:41 213:49 214:147 215:438 216:128 217:85 218:328 219:780 220:318 221:126 222:276 223:67 224:455 225:375 226:87 227:297 228:169 229:378 230:385 231:235 232:226 233:512
fastp,gen_n1000000_l245_merged.fq,1000000,245,999908,34107,965801,35.895,6:1603 7:1234 8:1087 9:483 10:1853 11:963 12:742 13:328 14:173 15:1336 16:815 17:308 18:203 19:130 20:1488 21:594 22:296 23:568 24:403 25:819 26:791 27:232 28:156 29:59 30:539 31:181 32:113 33:57 34:59 35:228 36:112 37:45 38:22 39:22 40:171 41:59 42:222 43:65 44:34 45:61 46:28 47:9 48:30 49:64 50:90 51:24 52:19 53:14 54:25 55:98 56:37 57:11 58:22 59:18 60:106 61:47 62:28 63:35 64:161 65:73 66:47 67:24 68:41 69:41 70:85 71:22 72:37 73:24 74:21 75:100 76:23 77:19 78:31 79:17 80:97 81:37 82:50 83:20 84:311 85:117 86:43 87:29 88:41 89:21 90:118 91:34 92:37 93:53 94:33 95:86 96:87 97:22 98:67 99:48 100:141 101:33 102:67 103:16 104:33 105:105 106:44 107:16 108:83 109:19 110:87 111:43 112:61 113:14 114:66 115:101 116:79 117:48 118:26 119:38 120:314 121:36 122:8 123:9 124:29 125:39 126:209 127:46 128:11 129:28 130:39 131:11 132:5 133:11 134:17 135:53 136:17 137:19 138:11 139:7 140:25 141:8 142:10 143:7 144:36 145:31 146:12 147:39 148:12 149:6 150:48 151:5 152:4 153:7 154:8 155:35 156:16 157:7 158:9 159:10 160:59 161:12 162:11 163:58 164:20 165:56 166:13 167:65 168:214 169:49 170:157 171:259 172:66 173:9 174:101 175:107 176:23 177:11 178:11 179:33 180:48 181:2 182:33 183:7 184:15 185:45 186:1 187:2 188:5 189:11 190:43 191:3 192:13 193:12 194:15 195:38 196:15 197:2 198:20 199:20 200:79 201:8 202:44 203:25 204:33 205:205 206:45 207:25 208:54 209:248 210:1117 211:23 212:38 213:34 214:121 215:438 216:82 217:85 218:315 219:815 220:658 221:96 222:222 223:59 224:418 225:604 226:64 227:252 228:134 229:320 230:684 231:176 232:142 233:209 234:701
fastp,gen_n1000000_l246_merged.fq,1000000,246,999926,32142,967784,38.59,7:898 8:1394 9:885 10:1356 11:773 12:872 13:407 14:305 15:1037 16:828 17:340 18:304 19:160 20:769 21:373 22:269 23:628 24:425 25:820 26:912 27:276 28:150 29:77 30:636 31:213 32:108 33:45 34:56 35:236 36:144 37:61 38:37 39:25 40:188 41:56 42:238 43:78 44:35 45:68 46:33 47:13 48:27 49:71 50:86 51:22 52:21 53:14 54:24 55:72 56:34 57:8 58:19 59:9 60:100 61:37 62:40 63:49 64:146 65:86 66:49 67:20 68:46 69:39 70:99 71:31 72:26 73:18 74:16 75:84 76:25 77:22 78:36 79:15 80:98 81:29 82:44 83:26 84:282 85:104 86:42 87:33 88:37 89:13 90:117 91:30 92:29 93:46 94:28 95:71 96:84 97:28 98:101 99:57 100:131 101:30 102:78 103:16 104:51 105:118 106:41 107:12 108:89 109:16 110:89 111:43 112:68 113:17 114:70 115:76 116:61 117:58 118:22 119:42 120:305 121:42 122:12 123:6 124:34 125:39 126:200 127:39 128:9 129:11 130:30 131:6 132:14 133:5 134:19 135:47 136:27 137:15 138:12 139:10 140:24 141:3 142:7 143:4 144:33 145:33 146:8 147:49 148:14 149:10 150:42 151:5 152:7 153:4 154:16 155:36 156:8 157:7 158:16 159:11 160:79 161:5 162:9 163:62 164:23 165:54 166:8 167:76 168:243 169:33 170:192 171:263 172:59 173:11 174:112 175:131 176:22 177:13 178:9 179:39 180:72 181:7 182:31 183:4 184:31 185:51 186:6 187:3 188:5 189:14 190:44 191:6 192:10 193:14 194:11 195:34 196:19 197:5 198:23 199:11 200:62 201:7 202:25 203:17 204:39 205:186 206:23 207:23 208:41 209:184 210:985 211:28 212:29 213:28 214:139 215:437 216:88 217:64 218:234 219:717 220:654 221:171 222:220 223:51 224:416 225:577 226:87 227:209 228:128 229:284 230:625 231:304 232:83 233:161 234:500 235:907
fastp,gen_n1000000_l247_merged.fq,1000000,247,999918,32086,967832,36.372,8:1428 9:1126 10:1774 11:715 12:1018 13:580 14:412 15:1154 16:609 17:272 18:323 19:171 20:897 21:369 22:281 23:706 24:475 25:939 26:987 27:342 28:169 29:85 30:672 31:224 32:131 33:56 34:49 35:286 36:135 37:67 38:33 39:23 40:190 41:67 42:302 43:87 44:42 45:89 46:21 47:17 48:22 49:64 50:93 51:30 52:22 53:17 54:26 55:91 56:34 57:15 58:15 59:11 60:103 61:25 62:24 63:33 64:168 65:71 66:42 67:29 68:57 69:43 70:87 71:21 72:36 73:14 74:28 75:103 76:34 77:24 78:33 79:22 80:95 81:31 82:37 83:22 84:292 85:128 86:38 87:28 88:43 89:16 90:117 91:38 92:38 93:54 94:36 95:97 96:82 97:25 98:73 99:46 100:127 101:20 102:82 103:19 104:48 105:123 106:53 107:13 108:77 109:22 110:103 111:55 112:55 113:19 114:56 115:93 116:50 117:42 118:35 119:42 120:276 121:80 122:37 123:2 124:34 125:53 126:217 127:32 128:4 129:11 130:30 131:5 132:8 133:11 134:14 135:60 136:11 137:18 138:18 139:6 140:37 141:7 142:9 143:4 144:30 145:25 146:19 147:46 148:6 149:8 150:33 151:5 152:6 153:4 154:14 155:38 156:16 157:7 158:8 159:13 160:70 161:8 162:6 163:44 164:20 165:57 166:11 167:66 168:204 169:45 170:167 171:224 172:63 173:13 174:96 175:101 176:12 177:17 178:12 179:31 180:64 181:6 182:26 183:5 184:25 185:41 186:5 187:5 188:7 189:11 190:41 191:4 192:12 193:14 194:7 195:22 196:15 197:7 198:17 199:10 200:56 201:7 202:38 203:9 204:32 205:148 206:22 207:24 208:36 209:158 210:929 211:25 212:33 213:29 214:100 215:376 216:60 217:63 218:257 219:634 220:574 221:125 222:297 223:36 224:317 225:482 226:77 227:288 228:96 229:263 230:447 231:194 232:180 233:97 234:281 235:639 236:554
fastp,gen_n1000000_l248_merged.fq,1000000,248,999911,31606,968305,34.959,9:1048 10:2363 11:1068 12:584 13:515 14:513 15:1320 16:755 17:248 18:373 19:210 20:1022 21:407 22:201 23:798 24:520 25:1005 26:1143 27:382 28:213 29:112 30:750 31:263 32:135 33:62 34:69 35:326 36:125 37:63 38:48 39:25 40:202 41:75 42:336 43:84 44:47 45:87 46:37 47:12 48:46 49:64 50:73 51:25 52:22 53:16 54:34 55:99 56:29 57:16 58:24 59:10 60:103 61:25 62:29 63:32 64:160 65:95 66:47 67:22 68:55 69:46 70:95 71:36 72:37 73:26 74:25 75:86 76:38 77:25 78:24 79:20 80:99 81:27 82:18 83:19 84:317 85:118 86:43 87:32 88:29 89:18 90:144 91:32 92:39 93:27 94:36 95:79 96:75 97:34 98:79 99:42 100:127 101:36 102:73 103:19 104:52 105:129 106:41 107:13 108:86 109:17 110:95 111:42 112:63 113:18 114:86 115:82 116:74 117:46 118:26 119:33 120:285 121:49 122:50 123:43 124:40 125:28 126:190 127:39 128:20 129:15 130:30 131:4 132:8 133:12 134:11 135:42 136:27 137:11 138:18 139:6 140:37 141:12 142:18 143:4 144:39 145:30 146:3 147:43 148:7 149:5 150:40 151:6 152:6 153:14 154:8 155:38 156:13 157:4 158:15 159:14 160:66 161:7 162:10 163:69 164:24 165:53 166:14 167:64 168:191 169:49 170:190 171:229 172:63 173:10 174:106 175:104 176:20 177:14 178:9 179:25 180:54 181:5 182:32 183:7 184:25 185:40 186:3 187:4 188:6 189:19 190:42 191:2 192:15 193:9 194:9 195:23 196:17 197:7 198:13 199:13 200:41 201:8 202:34 203:11 204:19 205:130 206:23 207:21 208:29 209:148 210:845 211:12 212:15 213:25 214:98 215:329 216:44 217:50 218:219 219:517 220:517 221:72 222:227 223:64 224:266 225:425 226:65 227:242 228:133 229:211 230:373 231:166 232:82 233:214 234:272 235:447 236:337 237:434
fastp,gen_n1000000_l249_merged.fq,1000000,249,999912,31856,968056,34.14,10:2412 11:1350 12:873 13:395 14:565 15:1567 16:944 17:338 18:246 19:163 20:1141 21:500 22:203 23:622 24:477 25:1139 26:1331 27:434 28:232 29:105 30:822 31:309 32:145 33:74 34:67 35:338 36:170 37:83 38:49 39:39 40:235 41:94 42:355 43:106 44:42 45:124 46:40 47:13 48:38 49:64 50:90 51:30 52:27 53:17 54:15 55:77 56:31 57:15 58:24 59:8 60:110 61:26 62:23 63:34 64:116 65:92 66:42 67:19 68:44 69:40 70:93 71:39 72:39 73:17 74:28 75:103 76:36 77:24 78:31 79:15 80:84 81:37 82:17 83:20 84:286 85:120 86:43 87:20 88:30 89:19 90:114 91:28 92:36 93:16 94:46 95:74 96:76 97:24 98:79 99:48 100:134 101:26 102:78 103:21 104:44 105:117 106:57 107:22 108:83 109:14 110:102 111:55 112:71 113:19 114:87 115:80 116:60 117:43 118:38 119:33 120:291 121:47 122:37 123:31 124:121 125:39 126:194 127:50 128:17 129:12 130:21 131:6 132:11 133:6 134:14 135:54 136:31 137:14 138:9 139:13 140:31 141:8 142:6 143:6 144:27 145:42 146:6 147:48 148:5 149:5 150:28 151:4 152:7 153:4 154:6 155:33 156:5 157:6 158:6 159:7 160:78 161:7 162:7 163:64 164:14 165:49 166:14 167:81 168:242 169:44 170:166 171:247 172:69 173:14 174:84 175:100 176:20 177:18 178:10 179:35 180:55 181:8 182:25 183:10 184:14 185:50 186:3 187:7 188:5 189:10 190:36 191:5 192:12 193:11 194:10 195:28 196:15 197:3 198:17 199:5 200:37 201:8 202:20 203:7 204:21 205:125 206:17 207:19 208:23 209:141 210:751 211:17 212:17 213:20 214:79 215:269 216:60 217:54 218:164 219:451 220:422 221:62 222:227 223:82 224:448 225:354 226:53 227:195 228:126 229:312 230:332 231:143 232:75 233:148 234:354 235:372 236:185 237:197 238:519
fastp,gen_n1000000_l24_merged.fq,1000000,24,999929,1000000,-71,0.115,0:975691 1:22343 2:1146 3:254 4:543 5:22 6:1
fastp,gen_n1000000_l250_merged.fq,1000000,250,999916,30741,969175,36.788,11:612 12:1103 13:635 14:337 15:1608 16:1129 17:421 18:302 19:126 20:1224 21:575 22:294 23:748 24:406 25:1193 26:1447 27:491 28:279 29:127 30:917 31:331 32:171 33:99 34:93 35:415 36:210 37:100 38:40 39:42 40:263 41:94 42:407 43:105 44:40 45:119 46:46 47:15 48:33 49:72 50:86 51:26 52:31 53:18 54:22 55:84 56:42 57:12 58:9 59:8 60:79 61:29 62:29 63:39 64:166 65:84 66:42 67:27 68:47 69:46 70:98 71:20 72:32 73:22 74:24 75:88 76:35 77:23 78:29 79:17 80:82 81:23 82:24 83:14 84:283 85:109 86:40 87:27 88:40 89:19 90:113 91:33 92:36 93:19 94:38 95:85 96:93 97:17 98:81 99:36 100:98 101:32 102:92 103:21 104:55 105:116 106:54 107:17 108:91 109:12 110:98 111:53 112:65 113:15 114:65 115:80 116:52 117:49 118:29 119:38 120:211 121:45 122:41 123:33 124:102 125:173 126:192 127:37 128:17 129:14 130:25 131:5 132:3 133:11 134:16 135:36 136:21 137:19 138:17 139:3 140:37 141:5 142:3 143:7 144:30 145:30 146:10 147:49 148:10 149:6 150:37 151:9 152:8 153:5 154:12 155:38 156:5 157:4 158:7 159:13 160:69 161:7 162:8 163:53 164:21 165:67 166:10 167:68 168:227 169:39 170:169 171:270 172:57 173:15 174:100 175:116 176:14 177:7 178:13 179:42 180:46 181:5 182:24 183:5 184:21 185:51 186:4 187:1 188:10 189:18 190:29 191:2 192:10 193:10 194:14 195:37 196:13 197:4 198:15 199:8 200:34 201:5 202:21 203:9 204:21 205:98 206:18 207:14 208:22 209:122 210:710 211:21 212:15 213:20 214:75 215:278 216:48 217:52 218:133 219:410 220:415 221:49 222:188 223:39 224:400 225:651 226:54 227:151 228:103 229:274 230:528 231:129 232:59 233:120 234:327 235:530 236:142 237:102 238:277 239:705
fastp,gen_n1000000_l25_merged.fq,1000000,25,999922,1000000,-78,0.11,0:975282 1:23022 2:986 3:216 4:489 5:4 6:1
fastp,gen_n1000000_l26_merged.fq,1000000,26,999912,1000000,-88,0.109,0:974525 1:23863 2:954 3:183 4:463 5:11 6:1
fastp,gen_n1000000_l27_merged.fq,1000000,27,999930,1000000,-70,0.105,0:974036 1:24500 2:974 3:144 4:341 5:5
fastp,gen_n1000000_l28_merged.fq,1000000,28,999922,1000000,-78,0.104,0:973251 1:25328 2:942 3:143 4:336
fastp,gen_n1000000_l29_merged.fq,1000000,29,999909,1000000,-91,0.102,0:972531 1:26196 2:861 3:117 4:289 5:6
fastp,gen_n1000000_l2_merged.fq,1000000,2,999928,0,999928,NA,
fastp,gen_n1000000_l30_merged.fq,1000000,30,999937,1000000,-63,0.1,0:971890 1:26841 2:853 3:107 4:304 5:4 6:1
fastp,gen_n1000000_l31_merged.fq,1000000,31,999928,1000000,-72,0.1,0:970828 1:28006 2:834 3:82 4:242 5:8
fastp,gen_n1000000_l32_merged.fq,1000000,32,999921,1000000,-79,0.098,0:970317 1:28568 2:804 3:77 4:232 5:2
fastp,gen_n1000000_l33_merged.fq,1000000,33,999929,1000000,-71,0.097,0:969513 1:29431 2:807 3:56 4:190 5:3
fastp,gen_n1000000_l34_merged.fq,1000000,34,999934,1000000,-66,0.097,0:968487 1:30412 2:833 3:67 4:196 5:5
fastp,gen_n1000000_l35_merged.fq,1000000,35,999903,1000000,-97,0.096,0:967691 1:31278 2:824 3:69 4:135 5:3
fastp,gen_n1000000_l36_merged.fq,1000000,36,999918,1000000,-82,0.096,0:966749 1:32213 2:806 3:49 4:177 5:6
fastp,gen_n1000000_l37_merged.fq,1000000,37,999921,1000000,-79,0.095,0:966271 1:32768 2:793 3:48 4:120
fastp,gen_n1000000_l38_merged.fq,1000000,38,999917,1000000,-83,0.096,0:964806 1:34186 2:790 3:47 4:169 5:2
fastp,gen_n1000000_l39_merged.fq,1000000,39,999919,1000000,-81,0.095,0:964185 1:34846 2:836 3:39 4:88 5:6
fastp,gen_n1000000_l3_merged.fq,1000000,3,999926,0,999926,NA,
fastp,gen_n1000000_l40_merged.fq,1000000,40,999920,1000000,-80,0.094,0:963429 1:35637 2:794 3:45 4:92 5:3
fastp,gen_n1000000_l41_merged.fq,1000000,41,999900,1000000,-100,0.094,0:962486 1:36531 2:872 3:29 4:81 5:1
fastp,gen_n1000000_l42_merged.fq,1000000,42,999906,1000000,-94,0.095,0:961405 1:37605 2:879 3:26 4:85
fastp,gen_n1000000_l43_merged.fq,1000000,43,999921,1000000,-79,0.094,0:960584 1:38398 2:920 3:33 4:64 5:1
fastp,gen_n1000000_l44_merged.fq,1000000,44,999910,1000000,-90,0.094,0:959995 1:38978 2:915 3:34 4:73 5:5
fastp,gen_n1000000_l45_merged.fq,1000000,45,999912,1000000,-88,0.095,0:958431 1:40570 2:927 3:34 4:38
fastp,gen_n1000000_l46_merged.fq,1000000,46,999923,1000000,-77,0.094,0:958125 1:40789 2:990 3:22 4:48 5:17 6:7 8:2
fastp,gen_n1000000_l47_merged.fq,1000000,47,999928,1000000,-72,0.095,0:956765 1:42104 2:1012 3:24 4:65 5:27 6:3
fastp,gen_n1000000_l48_merged.fq,1000000,48,999923,1000000,-77,0.096,0:955625 1:43118 2:1027 3:24 4:122 5:71 6:10 7:1 8:2
fastp,gen_n1000000_l49_merged.fq,1000000,49,999925,1000000,-75,0.097,0:954507 1:44155 2:1018 3:44 4:134 5:98 6:26 8:5 10:8 12:5
fastp,gen_n1000000_l4_merged.fq,1000000,4,999896,0,999896,NA,
fastp,gen_n1000000_l50_merged.fq,1000000,50,999927,1000000,-73,0.1,0:953251 1:45060 2:1151 3:29 4:166 5:248 6:51 7:7 8:8 9:1 10:18 12:10
fastp,gen_n1000000_l51_merged.fq,1000000,51,999919,1000000,-81,0.099,0:952770 1:45553 2:1148 3:32 4:178 5:225 6:55 7:1 8:14 9:1 10:15 12:7 13:1
fastp,gen_n1000000_l52_merged.fq,1000000,52,999920,1000000,-80,0.099,0:951639 1:46635 2:1229 3:41 4:139 5:223 6:54 7:1 8:16 9:2 10:14 11:1 12:5 14:1
fastp,gen_n1000000_l53_merged.fq,1000000,53,999912,1000000,-88,0.099,0:951052 1:47115 2:1279 3:41 4:172 5:247 6:45 7:2 8:11 9:5 10:21 12:10
fastp,gen_n1000000_l54_merged.fq,1000000,54,999922,1000000,-78,0.099,0:949824 1:48313 2:1322 3:36 4:160 5:249 6:55 7:1 8:14 9:4 10:14 11:2 12:5 13:1
fastp,gen_n1000000_l55_merged.fq,1000000,55,999914,1000000,-86,0.1,0:948507 1:49589 2:1350 3:38 4:167 5:247 6:64 7:4 8:8 9:3 10:15 12:8
fastp,gen_n1000000_l56_merged.fq,1000000,56,999916,1000000,-84,0.1,0:947379 1:50691 2:1425 3:44 4:167 5:213 6:43 8:15 9:2 10:17 12:4
fastp,gen_n1000000_l57_merged.fq,1000000,57,999900,1000000,-100,0.1,0:946625 1:51394 2:1465 3:45 4:142 5:237 6:59 7:3 8:6 9:4 10:14 11:1 12:4 14:1
fastp,gen_n1000000_l58_merged.fq,1000000,58,999915,1000000,-85,0.101,0:945397 1:52489 2:1572 3:48 4:172 5:232 6:49 7:2 8:12 9:1 10:15 12:10 14:1
fastp,gen_n1000000_l59_merged.fq,1000000,59,999905,1000000,-95,0.1,0:944922 1:53007 2:1521 3:46 4:158 5:253 6:56 7:1 8:7 9:2 10:20 11:1 12:6
fastp,gen_n1000000_l5_merged.fq,1000000,5,999925,0,999925,NA,
fastp,gen_n1000000_l60_merged.fq,1000000,60,999917,1000000,-83,0.1,0:943765 1:54080 2:1592 3:49 4:173 5:236 6:60 7:2 8:8 9:1 10:21 11:3 12:10
fastp,gen_n1000000_l61_merged.fq,1000000,61,999918,1000000,-82,0.099,0:943342 1:54523 2:1583 3:47 4:166 5:240 6:51 7:4 8:9 9:3 10:24 11:1 12:7
fastp,gen_n1000000_l62_merged.fq,1000000,62,999910,1000000,-90,0.1,0:941808 1:55915 2:1723 3:54 4:165 5:236 6:49 7:7 8:14 9:4 10:22 11:1 12:2
fastp,gen_n1000000_l63_merged.fq,1000000,63,999911,1000000,-89,0.101,0:940678 1:56971 2:1806 3:38 4:144 5:248 6:52 7:4 8:16 9:2 10:25 11:1 12:15
fastp,gen_n1000000_l64_merged.fq,1000000,64,999922,1000000,-78,0.101,0:939510 1:58102 2:1806 3:48 4:161 5:243 6:79 7:3 8:18 9:1 10:19 11:1 12:8 14:1
fastp,gen_n1000000_l65_merged.fq,1000000,65,999920,1000000,-80,0.101,0:938448 1:59100 2:1904 3:67 4:145 5:227 6:59 7:4 8:15 9:2 10:19 11:2 12:8
fastp,gen_n1000000_l66_merged.fq,1000000,66,999904,1000000,-96,0.101,0:937562 1:59827 2:1994 3:69 4:186 5:262 6:47 7:3 8:21 9:3 10:19 11:2 12:2 13:3
fastp,gen_n1000000_l67_merged.fq,1000000,67,999925,1000000,-75,0.101,0:936602 1:60834 2:2033 3:51 4:153 5:231 6:48 7:6 8:8 9:4 10:24 11:3 12:3
fastp,gen_n1000000_l68_merged.fq,1000000,68,999915,1000000,-85,0.101,0:935416 1:61948 2:2106 3:81 4:154 5:202 6:51 7:3 8:11 10:16 11:2 12:8 13:1 14:1
fastp,gen_n1000000_l69_merged.fq,1000000,69,999916,1000000,-84,0.101,0:934355 1:62896 2:2206 3:75 4:145 5:217 6:60 7:2 8:10 9:5 10:16 11:1 12:11 14:1
fastp,gen_n1000000_l6_merged.fq,1000000,6,999916,401,999515,99.751,5:7 6:393 7:1
fastp,gen_n1000000_l70_merged.fq,1000000,70,999901,1000000,-99,0.101,0:933241 1:64039 2:2198 3:67 4:172 5:192 6:44 7:5 8:13 9:3 10:18 12:7 13:1
fastp,gen_n1000000_l71_merged.fq,1000000,71,999895,1000000,-105,0.101,0:932482 1:64674 2:2299 3:74 4:143 5:218 6:66 7:2 8:9 9:2 10:25 11:3 12:2 13:1
fastp,gen_n1000000_l72_merged.fq,1000000,72,999909,1000000,-91,0.102,0:931481 1:65543 2:2367 3:80 4:179 5:252 6:55 7:2 8:8 9:6 10:15 11:2 12:9 13:1
fastp,gen_n1000000_l73_merged.fq,1000000,73,999926,1000000,-74,0.102,0:930191 1:66824 2:2430 3:73 4:175 5:205 6:59 7:7 8:10 9:1 10:19 11:1 12:4 14:1
fastp,gen_n1000000_l74_merged.fq,1000000,74,999914,1000000,-86,0.102,0:929324 1:67545 2:2528 3:76 4:160 5:254 6:63 7:5 8:14 9:2 10:18 11:2 12:8 14:1
fastp,gen_n1000000_l75_merged.fq,1000000,75,999929,1000000,-71,0.103,0:927812 1:69038 2:2572 3:79 4:164 5:213 6:68 7:6 8:11 9:5 10:17 11:2 12:11 13:2
fastp,gen_n1000000_l76_merged.fq,1000000,76,999914,1000000,-86,0.103,0:926773 1:69978 2:2659 3:83 4:164 5:219 6:74 7:8 8:14 9:4 10:17 11:2 12:4 15:1
fastp,gen_n1000000_l77_merged.fq,1000000,77,999902,1000000,-98,0.103,0:926189 1:70577 2:2616 3:89 4:155 5:244 6:63 7:5 8:14 9:4 10:26 11:5 12:10 13:1 14:2
fastp,gen_n1000000_l78_merged.fq,1000000,78,999918,1000000,-82,0.103,0:924480 1:72167 2:2756 3:106 4:156 5:226 6:66 7:7 8:12 9:1 10:17 11:1 12:5
fastp,gen_n1000000_l79_merged.fq,1000000,79,999921,1000000,-79,0.103,0:923854 1:72718 2:2891 3:91 4:143 5:204 6:48 7:6 8:11 9:4 10:13 11:4 12:11 13:1 14:1
fastp,gen_n1000000_l7_merged.fq,1000000,7,999912,0,999912,NA,
fastp,gen_n1000000_l80_merged.fq,1000000,80,999907,1000000,-93,0.103,0:922467 1:74033 2:2918 3:100 4:137 5:229 6:62 7:4 8:11 9:6 10:22 11:4 12:5 13:1 15:1
fastp,gen_n1000000_l81_merged.fq,1000000,81,999923,1000000,-77,0.104,0:921271 1:75012 2:3116 3:113 4:159 5:213 6:54 7:10 8:16 9:2 10:19 11:6 12:7 13:2
fastp,gen_n1000000_l82_merged.fq,1000000,82,999924,1000000,-76,0.104,0:919910 1:76200 2:3269 3:134 4:158 5:226 6:59 7:8 8:18 10:10 12:8
fastp,gen_n1000000_l83_merged.fq,1000000,83,999923,1000000,-77,0.104,0:919022 1:77100 2:3282 3:103 4:151 5:235 6:66 7:6 8:6 9:1 10:17 11:1 12:9 14:1
fastp,gen_n1000000_l84_merged.fq,1000000,84,999906,1000000,-94,0.104,0:917992 1:78060 2:3348 3:127 4:162 5:210 6:59 7:6 8:9 10:20 12:6 13:1
fastp,gen_n1000000_l85_merged.fq,1000000,85,999916,1000000,-84,0.106,0:915779 1:80070 2:3557 3:100 4:149 5:228 6:58 7:9 8:15 9:5 10:19 11:4 12:6 13:1
fastp,gen_n1000000_l86_merged.fq,1000000,86,999921,1000000,-79,0.105,0:915390 1:80474 2:3502 3:118 4:166 5:237 6:66 7:8 8:10 9:4 10:17 11:2 12:5 13:1
fastp,gen_n1000000_l87_merged.fq,1000000,87,999935,1000000,-65,0.106,0:913909 1:81729 2:3717 3:136 4:145 5:245 6:72 7:4 8:9 9:8 10:17 11:4 12:4 13:1
fastp,gen_n1000000_l88_merged.fq,1000000,88,999924,1000000,-76,0.106,0:912921 1:82751 2:3720 3:134 4:137 5:221 6:59 7:5 8:17 9:2 10:20 11:4 12:7 13:2
fastp,gen_n1000000_l89_merged.fq,1000000,89,999911,1000000,-89,0.106,0:912068 1:83364 2:3914 3:134 4:162 5:236 6:78 7:10 8:7 9:5 10:14 12:7 14:1
fastp,gen_n1000000_l8_merged.fq,1000000,8,999921,610,999311,55.369,3:7 4:501 5:2 6:33 7:67
fastp,gen_n1000000_l90_merged.fq,1000000,90,999923,1000000,-77,0.106,0:910802 1:84595 2:3998 3:141 4:140 5:206 6:67 7:7 8:12 9:1 10:15 11:4 12:10 13:2
fastp,gen_n1000000_l91_merged.fq,1000000,91,999915,1000000,-85,0.107,0:909335 1:85935 2:4118 3:134 4:141 5:216 6:70 7:8 8:11 9:4 10:16 11:4 12:7 13:1
fastp,gen_n1000000_l92_merged.fq,1000000,92,999916,1000000,-84,0.107,0:907875 1:87324 2:4153 3:151 4:146 5:223 6:76 7:11 8:9 9:3 10:19 11:3 12:5 13:1 14:1
fastp,gen_n1000000_l93_merged.fq,1000000,93,999908,1000000,-92,0.108,0:906560 1:88524 2:4267 3:166 4:132 5:215 6:83 7:8 8:13 9:5 10:17 11:3 12:6 13:1
fastp,gen_n1000000_l94_merged.fq,1000000,94,999916,1000000,-84,0.108,0:905610 1:89382 2:4352 3:167 4:143 5:223 6:75 7:7 8:9 9:4 10:16 11:5 12:6 13:1
fastp,gen_n1000000_l95_merged.fq,1000000,95,999918,1000000,-82,0.108,0:904129 1:90704 2:4526 3:177 4:141 5:212 6:66 7:10 8:8 9:2 10:16 11:3 12:6
fastp,gen_n1000000_l96_merged.fq,1000000,96,999915,1000000,-85,0.108,0:902967 1:91707 2:4673 3:186 4:128 5:226 6:71 7:9 8:6 9:3 10:11 11:6 12:5 13:1 14:1
fastp,gen_n1000000_l97_merged.fq,1000000,97,999915,1000000,-85,0.108,0:902102 1:92396 2:4799 3:216 4:145 5:222 6:72 7:9 8:8 9:5 10:15 11:3 12:5 13:2 15:1
fastp,gen_n1000000_l98_merged.fq,1000000,98,999919,1000000,-81,0.109,0:900548 1:93886 2:4882 3:171 4:158 5:220 6:83 7:14 8:8 9:4 10:23 12:2 13:1
fastp,gen_n1000000_l99_merged.fq,1000000,99,999915,1000000,-85,0.109,0:899698 1:94580 2:4985 3:218 4:146 5:231 6:82 7:15 8:12 9:1 10:21 11:3 12:5 13:2 14:1
fastp,gen_n1000000_l9_merged.fq,1000000,9,999911,961,998950,22.442,2:954 3:1 5:6
