program,filename,nfrags,fraglen,total_sequences,total_reads,dropped_reads,avg_divergence_per_nt,edit_distances
leeHom,gen_n1000000_l1000_merged.fq.gz,1000000,1000,999921,14580,985341,81.207,761:319 762:401 763:251 764:471 765:416 766:182 767:119 768:166 769:270 770:314 771:55 772:68 773:123 774:208 775:189 776:82 777:46 778:102 779:216 780:211 781:44 782:58 783:153 784:161 785:129 786:48 787:105 788:160 789:174 790:175 791:68 792:74 793:255 794:159 795:126 796:117 797:149 798:293 799:123 800:95 801:33 802:21 803:73 804:127 805:61 806:20 807:37 808:62 809:104 810:108 811:31 812:33 813:71 814:103 815:74 816:48 817:32 818:73 819:105 820:63 821:28 822:92 823:52 824:85 825:61 826:13 827:25 828:62 829:87 830:79 831:28 832:207 833:65 834:62 835:67 836:70 837:34 838:72 839:106 840:131 841:12 842:19 843:63 844:69 845:43 846:106 847:40 848:176 849:521 850:1595 851:355 852:112 853:199 854:288 855:184 856:46 857:42 858:92 859:51 860:39 861:21 862:22 863:66 864:82 865:27 866:41 867:34 868:63 869:39 870:38 871:19 872:67 873:75 874:145 875:29 876:24 877:75 878:29 879:12 880:6 881:2 882:10 883:14 884:2 885:2 886:1 887:1 888:1 890:1
leeHom,gen_n1000000_l100_merged.fq.gz,1000000,100,999928,1000000,-72,0.022,0:977788 1:21967 2:242 3:3
leeHom,gen_n1000000_l101_merged.fq.gz,1000000,101,999921,1000000,-79,0.022,0:977860 1:21880 2:258 3:2
leeHom,gen_n1000000_l102_merged.fq.gz,1000000,102,999926,1000000,-74,0.022,0:977412 1:22355 2:230 3:3
leeHom,gen_n1000000_l103_merged.fq.gz,1000000,103,999915,1000000,-85,0.022,0:977422 1:22321 2:254 3:2 4:1
leeHom,gen_n1000000_l104_merged.fq.gz,1000000,104,999911,1000000,-89,0.022,0:977094 1:22651 2:248 3:7
leeHom,gen_n1000000_l105_merged.fq.gz,1000000,105,999920,1000000,-80,0.022,0:976790 1:22941 2:266 3:3
leeHom,gen_n1000000_l106_merged.fq.gz,1000000,106,999938,1000000,-62,0.022,0:976769 1:22938 2:289 3:4
leeHom,gen_n1000000_l107_merged.fq.gz,1000000,107,999913,1000000,-87,0.023,0:975888 1:23829 2:280 3:3
leeHom,gen_n1000000_l108_merged.fq.gz,1000000,108,999922,999999,-77,0.022,0:976028 1:23667 2:304
leeHom,gen_n1000000_l109_merged.fq.gz,1000000,109,999923,1000000,-77,0.022,0:975780 1:23943 2:275 3:2
leeHom,gen_n1000000_l10_merged.fq.gz,1000000,10,999901,1000000,-99,0.024,0:997596 1:2402 2:2
leeHom,gen_n1000000_l110_merged.fq.gz,1000000,110,999916,1000000,-84,0.023,0:975480 1:24238 2:276 3:6
leeHom,gen_n1000000_l111_merged.fq.gz,1000000,111,999908,1000000,-92,0.023,0:975293 1:24389 2:314 3:4
leeHom,gen_n1000000_l112_merged.fq.gz,1000000,112,999924,1000000,-76,0.023,0:975132 1:24532 2:333 3:3
leeHom,gen_n1000000_l113_merged.fq.gz,1000000,113,999914,1000000,-86,0.022,0:974973 1:24707 2:317 3:3
leeHom,gen_n1000000_l114_merged.fq.gz,1000000,114,999932,1000000,-68,0.023,0:974279 1:25376 2:341 3:4
leeHom,gen_n1000000_l115_merged.fq.gz,1000000,115,999935,1000000,-65,0.023,0:973990 1:25669 2:340 4:1
leeHom,gen_n1000000_l116_merged.fq.gz,1000000,116,999926,1000000,-74,0.023,0:974041 1:25626 2:329 3:4
leeHom,gen_n1000000_l117_merged.fq.gz,1000000,117,999917,1000000,-83,0.023,0:973592 1:26080 2:326 3:2
leeHom,gen_n1000000_l118_merged.fq.gz,1000000,118,999936,1000000,-64,0.023,0:973247 1:26398 2:350 3:5
leeHom,gen_n1000000_l119_merged.fq.gz,1000000,119,999928,999999,-71,0.023,0:973008 1:26635 2:354 3:2
leeHom,gen_n1000000_l11_merged.fq.gz,1000000,11,999928,1000000,-72,0.022,0:997530 1:2468 2:2
leeHom,gen_n1000000_l120_merged.fq.gz,1000000,120,999913,1000000,-87,0.023,0:972643 1:26965 2:389 3:3
leeHom,gen_n1000000_l121_merged.fq.gz,1000000,121,999915,1000000,-85,0.023,0:972732 1:26907 2:357 3:4
leeHom,gen_n1000000_l122_merged.fq.gz,1000000,122,999926,999999,-73,0.023,0:972253 1:27374 2:365 3:7
leeHom,gen_n1000000_l123_merged.fq.gz,1000000,123,999926,1000000,-74,0.023,0:971920 1:27688 2:388 3:4
leeHom,gen_n1000000_l124_merged.fq.gz,1000000,124,999907,1000000,-93,0.023,0:971477 1:28097 2:421 3:5
leeHom,gen_n1000000_l125_merged.fq.gz,1000000,125,999938,1000000,-62,0.023,0:971489 1:28100 2:409 3:2
leeHom,gen_n1000000_l126_merged.fq.gz,1000000,126,999918,1000000,-82,0.025,0:968779 1:30709 2:508 3:4
leeHom,gen_n1000000_l127_merged.fq.gz,1000000,127,999911,1000000,-89,0.027,0:966659 1:32792 2:545 3:4
leeHom,gen_n1000000_l128_merged.fq.gz,1000000,128,999924,1000000,-76,0.028,0:964425 1:34943 2:627 3:5
leeHom,gen_n1000000_l129_merged.fq.gz,1000000,129,999908,999998,-90,0.03,0:961541 1:37763 2:682 3:11 4:1
leeHom,gen_n1000000_l12_merged.fq.gz,1000000,12,999912,1000000,-88,0.022,0:997398 1:2597 2:5
leeHom,gen_n1000000_l130_merged.fq.gz,1000000,130,999922,999992,-70,0.033,0:958546 1:40565 2:864 3:13 5:1 6:3
leeHom,gen_n1000000_l131_merged.fq.gz,1000000,131,999914,999998,-84,0.035,0:955676 1:43294 2:1003 3:9 5:2 6:14
leeHom,gen_n1000000_l132_merged.fq.gz,1000000,132,999903,999998,-95,0.037,0:952609 1:46293 2:1058 3:16 5:2 6:20
leeHom,gen_n1000000_l133_merged.fq.gz,1000000,133,999924,1000000,-76,0.038,0:950406 1:48289 2:1258 3:17 4:1 5:2 6:26 7:1
leeHom,gen_n1000000_l134_merged.fq.gz,1000000,134,999910,999996,-86,0.04,0:948200 1:50478 2:1283 3:17 5:1 6:17
leeHom,gen_n1000000_l135_merged.fq.gz,1000000,135,999914,999998,-84,0.041,0:946219 1:52306 2:1422 3:36 6:14 7:1
leeHom,gen_n1000000_l136_merged.fq.gz,1000000,136,999919,999996,-77,0.043,0:943376 1:54954 2:1623 3:29 6:12 10:1 12:1
leeHom,gen_n1000000_l137_merged.fq.gz,1000000,137,999921,999997,-76,0.044,0:941536 1:56705 2:1700 3:32 10:2 12:22
leeHom,gen_n1000000_l138_merged.fq.gz,1000000,138,999916,999997,-81,0.046,0:939080 1:58999 2:1871 3:33 4:1 10:2 12:10 13:1
leeHom,gen_n1000000_l139_merged.fq.gz,1000000,139,999922,999995,-73,0.047,0:936363 1:61573 2:2004 3:36 4:1 6:1 12:16 13:1
leeHom,gen_n1000000_l13_merged.fq.gz,1000000,13,999925,1000000,-75,0.022,0:997170 1:2828 2:2
leeHom,gen_n1000000_l140_merged.fq.gz,1000000,140,999928,999997,-69,0.049,0:934440 1:63375 2:2122 3:42 12:14 13:1 15:3
leeHom,gen_n1000000_l141_merged.fq.gz,1000000,141,999935,999996,-61,0.05,0:932533 1:65072 2:2307 3:60 4:2 12:18 15:3 18:1
leeHom,gen_n1000000_l142_merged.fq.gz,1000000,142,999939,999996,-57,0.051,0:929705 1:67769 2:2451 3:57 4:2 6:2 10:1 12:5 15:2 17:2
leeHom,gen_n1000000_l143_merged.fq.gz,1000000,143,999923,999997,-74,0.053,0:927698 1:69712 2:2515 3:56 4:2 15:2 16:1 18:11
leeHom,gen_n1000000_l144_merged.fq.gz,1000000,144,999931,999996,-65,0.054,0:925296 1:71813 2:2779 3:81 4:2 5:1 17:1 18:22 19:1
leeHom,gen_n1000000_l145_merged.fq.gz,1000000,145,999928,999997,-69,0.056,0:922588 1:74358 2:2958 3:65 4:2 6:2 11:1 13:2 17:1 18:16 20:2 22:1 24:1
leeHom,gen_n1000000_l146_merged.fq.gz,1000000,146,999929,999995,-66,0.057,0:920749 1:75970 2:3155 3:86 4:3 5:1 10:2 12:1 15:1 18:15 19:1 20:6 21:2 22:1 23:1 24:1
leeHom,gen_n1000000_l147_merged.fq.gz,1000000,147,999921,999989,-68,0.059,0:918006 1:78514 2:3340 3:88 4:2 13:1 15:2 17:1 18:15 20:7 21:2 22:1 23:4 24:4 25:1 26:1
leeHom,gen_n1000000_l148_merged.fq.gz,1000000,148,999912,999984,-72,0.06,0:915778 1:80611 2:3450 3:118 13:1 17:1 18:7 19:2 20:2 22:2 23:1 24:6 25:2 26:3
leeHom,gen_n1000000_l149_merged.fq.gz,1000000,149,999919,999979,-60,0.061,0:913953 1:82230 2:3635 3:114 4:1 15:1 19:1 20:3 21:2 22:1 23:1 24:23 25:7 26:3 27:1 28:3
leeHom,gen_n1000000_l14_merged.fq.gz,1000000,14,999918,1000000,-82,0.022,0:996881 1:3116 2:3
leeHom,gen_n1000000_l150_merged.fq.gz,1000000,150,999914,999982,-68,0.063,0:911324 1:84655 2:3788 3:142 12:2 13:1 15:1 16:1 18:3 20:1 21:1 22:5 23:2 24:38 25:5 26:7 27:2 28:4
leeHom,gen_n1000000_l151_merged.fq.gz,1000000,151,999923,999978,-55,0.064,0:909139 1:86559 2:4059 3:131 4:4 5:1 6:3 12:1 17:1 18:1 19:1 21:1 22:1 23:6 24:27 25:5 26:17 27:5 28:11 29:3 30:2
leeHom,gen_n1000000_l152_merged.fq.gz,1000000,152,999920,999976,-56,0.066,0:906931 1:88598 2:4219 3:137 15:1 17:1 18:2 20:3 21:2 22:5 23:3 24:16 25:8 26:13 27:5 28:14 29:12 30:5 31:1
leeHom,gen_n1000000_l153_merged.fq.gz,1000000,153,999914,999984,-70,0.068,0:904050 1:91104 2:4559 3:156 4:2 6:2 18:1 19:3 20:1 21:2 22:1 23:6 24:21 25:11 26:9 27:8 28:16 29:10 30:11 31:10 33:1
leeHom,gen_n1000000_l154_merged.fq.gz,1000000,154,999923,999975,-52,0.069,0:902125 1:92916 2:4659 3:146 4:4 6:1 12:1 17:1 18:1 19:1 20:5 21:1 22:1 23:2 24:16 25:7 26:8 27:13 28:17 29:7 30:26 31:13 32:2 33:2
leeHom,gen_n1000000_l155_merged.fq.gz,1000000,155,999916,999977,-61,0.071,0:899307 1:95395 2:4942 3:180 4:2 6:3 8:1 10:1 17:1 18:1 21:1 22:3 23:2 24:9 25:6 26:13 27:10 28:20 29:12 30:19 31:14 32:21 33:10 34:3 35:1
leeHom,gen_n1000000_l156_merged.fq.gz,1000000,156,999920,999976,-56,0.072,0:897596 1:96888 2:5145 3:181 4:1 6:1 9:1 10:1 16:1 17:2 18:1 20:1 22:2 23:3 24:8 25:8 26:7 27:13 28:18 29:14 30:21 31:19 32:19 33:16 34:7 35:2
leeHom,gen_n1000000_l157_merged.fq.gz,1000000,157,999892,999981,-89,0.074,0:895263 1:98927 2:5357 3:214 4:7 6:1 8:1 12:1 14:1 15:1 17:1 18:1 19:2 20:2 21:2 22:2 23:4 24:8 25:7 26:12 27:11 28:18 29:15 30:43 31:21 32:18 33:14 34:15 35:7 36:4 38:1
leeHom,gen_n1000000_l158_merged.fq.gz,1000000,158,999933,999966,-33,0.075,0:893072 1:100828 2:5648 3:194 4:5 12:3 16:1 17:1 18:2 20:3 21:3 22:1 23:2 24:13 25:6 26:8 27:10 28:18 29:20 30:40 31:19 32:19 33:18 34:18 35:8 36:4 37:2
leeHom,gen_n1000000_l159_merged.fq.gz,1000000,159,999910,999964,-54,0.077,0:891169 1:102535 2:5778 3:237 4:3 8:1 12:1 16:1 18:1 19:1 20:2 21:2 22:3 24:11 25:5 26:11 27:11 28:24 29:21 30:33 31:11 32:28 33:20 34:23 35:18 36:10 37:1 38:3
leeHom,gen_n1000000_l15_merged.fq.gz,1000000,15,999906,1000000,-94,0.022,0:996749 1:3244 2:7
leeHom,gen_n1000000_l160_merged.fq.gz,1000000,160,999911,999970,-59,0.078,0:888675 1:104634 2:6163 3:235 4:5 14:1 15:1 16:2 18:1 20:2 22:2 23:3 24:15 25:6 26:11 27:11 28:21 29:22 30:30 31:17 32:21 33:18 34:21 35:12 36:24 37:9 38:5 39:1 40:2
leeHom,gen_n1000000_l161_merged.fq.gz,1000000,161,999908,999970,-62,0.08,0:886242 1:106846 2:6367 3:255 4:6 8:1 12:2 15:1 18:2 21:1 22:2 23:2 24:9 25:7 26:14 27:13 28:14 29:21 30:16 31:19 32:12 33:17 34:18 35:23 36:34 37:8 38:10 39:6 40:2
leeHom,gen_n1000000_l162_merged.fq.gz,1000000,162,999910,999967,-57,0.082,0:884204 1:108453 2:6719 3:263 4:9 10:1 16:1 18:1 19:1 20:2 21:3 22:2 23:5 24:5 25:5 26:14 27:7 28:17 29:25 30:22 31:27 32:26 33:23 34:27 35:18 36:30 37:13 38:17 39:15 40:7 41:3 42:1 43:1
leeHom,gen_n1000000_l163_merged.fq.gz,1000000,163,999933,999964,-31,0.083,0:881619 1:110854 2:6858 3:298 4:11 5:1 6:1 10:1 15:1 18:1 19:3 20:5 21:3 22:3 23:1 24:13 25:10 26:14 27:13 28:18 29:18 30:20 31:22 32:35 33:13 34:25 35:20 36:32 37:17 38:7 39:16 40:7 41:4
leeHom,gen_n1000000_l164_merged.fq.gz,1000000,164,999915,999956,-41,0.084,0:879750 1:112424 2:7172 3:297 4:7 6:2 20:1 21:1 22:2 23:6 24:8 25:8 26:18 27:7 28:17 29:24 30:30 31:14 32:12 33:13 34:15 35:13 36:41 37:12 38:19 39:20 40:8 41:8 42:6 43:1
leeHom,gen_n1000000_l165_merged.fq.gz,1000000,165,999917,999960,-43,0.086,0:877438 1:114497 2:7377 3:299 4:11 6:2 11:1 17:1 18:1 22:3 23:3 24:10 25:6 26:15 27:19 28:28 29:23 30:27 31:15 32:19 33:29 34:14 35:13 36:28 37:16 38:19 39:8 40:12 41:5 42:10 43:8 44:3
leeHom,gen_n1000000_l166_merged.fq.gz,1000000,166,999915,999945,-30,0.087,0:874939 1:116550 2:7745 3:360 4:12 5:1 6:2 8:1 10:1 12:1 18:2 19:1 20:2 22:1 23:2 24:13 25:6 26:13 27:9 28:29 29:21 30:21 31:9 32:13 33:15 34:16 35:12 36:16 37:15 38:25 39:12 40:20 41:11 42:16 43:19 44:8 45:6
leeHom,gen_n1000000_l167_merged.fq.gz,1000000,167,999913,999950,-37,0.09,0:872287 1:118993 2:7883 3:353 4:14 8:1 9:1 12:1 13:1 16:1 19:1 20:5 22:1 23:3 24:11 25:9 26:16 27:9 28:18 29:21 30:27 31:25 32:23 33:17 34:24 35:17 36:23 37:17 38:26 39:7 40:20 41:10 42:38 43:18 44:22 45:6 47:1
leeHom,gen_n1000000_l168_merged.fq.gz,1000000,168,999917,999951,-34,0.09,0:870305 1:120397 2:8462 3:396 4:9 6:1 12:3 20:3 22:1 23:5 24:13 25:6 26:9 27:11 28:17 29:20 30:26 31:7 32:15 33:15 34:22 35:19 36:24 37:15 38:30 39:19 40:9 41:17 42:31 43:17 44:14 45:4 46:3 47:4 48:1 49:1
leeHom,gen_n1000000_l169_merged.fq.gz,1000000,169,999922,999943,-21,0.092,0:868210 1:122351 2:8568 3:388 4:16 12:1 17:1 18:1 20:2 22:2 23:5 24:12 25:8 26:7 27:16 28:19 29:18 30:26 31:18 32:21 33:13 34:29 35:20 36:15 37:7 38:15 39:16 40:16 41:8 42:40 43:23 44:15 45:12 46:12 47:8 48:3 49:1
leeHom,gen_n1000000_l16_merged.fq.gz,1000000,16,999917,1000000,-83,0.022,0:996490 1:3508 2:2
leeHom,gen_n1000000_l170_merged.fq.gz,1000000,170,999923,999939,-16,0.094,0:865557 1:124471 2:8994 3:443 4:12 12:1 13:1 18:1 21:1 22:1 23:4 24:13 25:12 26:11 27:8 28:25 29:22 30:19 31:18 32:28 33:19 34:22 35:14 36:18 37:17 38:23 39:23 40:14 41:16 42:39 43:15 44:12 45:22 46:24 47:11 48:4 49:3 50:1
leeHom,gen_n1000000_l171_merged.fq.gz,1000000,171,999914,999938,-24,0.096,0:863281 1:126549 2:9162 3:445 4:19 12:1 15:1 18:1 19:1 21:1 22:1 23:1 24:7 25:5 26:12 27:20 28:17 29:22 30:29 31:20 32:13 33:21 34:28 35:20 36:20 37:12 38:24 39:12 40:19 41:17 42:44 43:24 44:16 45:17 46:15 47:15 48:6 49:13 50:5 51:2
leeHom,gen_n1000000_l172_merged.fq.gz,1000000,172,999922,999924,-2,0.098,0:860468 1:128955 2:9491 3:482 4:18 5:2 17:1 19:1 22:1 24:4 25:7 26:10 27:10 28:17 29:19 30:30 31:23 32:32 33:19 34:22 35:22 36:27 37:15 38:21 39:15 40:18 41:22 42:27 43:21 44:25 45:24 46:15 47:13 48:17 49:13 50:11 51:6
leeHom,gen_n1000000_l173_merged.fq.gz,1000000,173,999927,999936,-9,0.1,0:858303 1:130627 2:9972 3:485 4:12 5:1 6:1 16:1 17:2 18:2 19:1 20:2 22:3 23:2 24:4 25:4 26:8 27:12 28:17 29:28 30:32 31:25 32:10 33:25 34:29 35:23 36:21 37:16 38:22 39:16 40:17 41:9 42:18 43:29 44:24 45:17 46:13 47:13 48:34 49:20 50:13 51:12 52:6 53:5
leeHom,gen_n1000000_l174_merged.fq.gz,1000000,174,999914,999911,3,0.1,0:856489 1:132256 2:10083 3:515 4:18 5:1 6:1 9:1 12:1 16:3 17:1 18:5 19:1 20:3 22:1 23:2 24:7 25:1 26:11 27:14 28:17 29:24 30:25 31:27 32:28 33:24 34:22 35:24 36:20 37:13 38:21 39:21 40:13 41:9 42:19 43:25 44:21 45:12 46:14 47:10 48:41 49:13 50:16 51:15 52:11 53:7 54:3 55:1 56:1
leeHom,gen_n1000000_l175_merged.fq.gz,1000000,175,999925,999927,-2,0.102,0:854443 1:133766 2:10558 3:578 4:24 5:1 12:1 15:1 16:1 17:1 20:1 22:1 23:2 24:4 25:3 26:5 27:8 28:25 29:13 30:29 31:19 32:22 33:19 34:25 35:12 36:16 37:13 38:24 39:22 40:22 41:18 42:33 43:31 44:24 45:13 46:12 47:15 48:37 49:24 50:20 51:8 52:16 53:9 54:6 55:1 56:1
leeHom,gen_n1000000_l176_merged.fq.gz,1000000,176,999930,999910,20,0.105,0:851619 1:136401 2:10684 3:559 4:18 5:3 6:1 16:1 18:1 20:2 22:1 23:3 24:6 25:3 26:5 27:17 28:21 29:24 30:23 31:23 32:29 33:19 34:21 35:18 36:28 37:17 38:21 39:15 40:25 41:11 42:33 43:25 44:27 45:24 46:15 47:14 48:42 49:24 50:18 51:13 52:16 53:17 54:12 55:4 56:5 57:1 58:1
leeHom,gen_n1000000_l177_merged.fq.gz,1000000,177,999920,999918,2,0.105,0:849391 1:138152 2:11174 3:555 4:30 5:2 6:1 14:1 15:1 17:1 20:2 22:1 24:4 25:6 26:7 27:8 28:20 29:32 30:31 31:27 32:19 33:20 34:20 35:20 36:22 37:15 38:31 39:18 40:24 41:22 42:23 43:27 44:22 45:13 46:17 47:13 48:39 49:13 50:23 51:13 52:16 53:14 54:14 55:6 56:5 57:2 58:1
leeHom,gen_n1000000_l178_merged.fq.gz,1000000,178,999916,999910,6,0.107,0:847106 1:140158 2:11390 3:603 4:22 5:1 6:1 12:1 13:1 16:1 18:3 20:1 21:2 22:1 23:3 24:4 25:3 26:6 27:10 28:12 29:19 30:34 31:29 32:12 33:15 34:18 35:20 36:18 37:19 38:23 39:25 40:19 41:18 42:39 43:34 44:12 45:9 46:23 47:25 48:26 49:14 50:18 51:23 52:23 53:15 54:23 55:14 56:4 57:4 59:5 60:1
leeHom,gen_n1000000_l179_merged.fq.gz,1000000,179,999920,999908,12,0.108,0:844674 1:141939 2:11980 3:659 4:35 5:1 6:1 17:1 20:3 23:2 24:3 25:3 26:4 27:3 28:9 29:21 30:21 31:20 32:25 33:16 34:24 35:30 36:21 37:17 38:16 39:19 40:24 41:19 42:25 43:33 44:22 45:16 46:12 47:13 48:21 49:17 50:20 51:19 52:21 53:17 54:36 55:11 56:21 57:5 58:4 59:2 60:1 61:2
leeHom,gen_n1000000_l17_merged.fq.gz,1000000,17,999905,1000000,-95,0.022,0:996272 1:3721 2:7
leeHom,gen_n1000000_l180_merged.fq.gz,1000000,180,999915,999904,11,0.11,0:842495 1:143923 2:12118 3:665 4:33 5:2 6:1 10:1 12:2 15:1 18:3 20:1 22:2 23:4 24:9 25:4 26:4 27:3 28:11 29:24 30:15 31:28 32:22 33:28 34:20 35:21 36:23 37:27 38:22 39:17 40:22 41:16 42:28 43:29 44:22 45:13 46:16 47:20 48:28 49:20 50:8 51:13 52:23 53:17 54:42 55:8 56:22 57:7 58:8 59:7 60:2 61:2 62:2
leeHom,gen_n1000000_l181_merged.fq.gz,1000000,181,999924,999897,27,0.113,0:839885 1:145977 2:12573 3:706 4:46 6:1 8:1 12:1 14:1 15:1 16:1 20:1 22:1 23:1 24:5 25:2 26:4 27:6 28:5 29:12 30:30 31:20 32:23 33:32 34:23 35:21 36:19 37:19 38:26 39:26 40:24 41:16 42:32 43:27 44:27 45:14 46:17 47:14 48:38 49:18 50:13 51:15 52:25 53:19 54:31 55:15 56:28 57:11 58:21 59:7 60:7 61:5 62:4
leeHom,gen_n1000000_l182_merged.fq.gz,1000000,182,999910,999898,12,0.114,0:837722 1:147935 2:12726 3:781 4:29 5:1 10:1 12:2 14:1 15:1 18:1 20:3 23:3 24:4 25:4 26:1 27:3 28:9 29:10 30:17 31:28 32:25 33:16 34:34 35:17 36:25 37:24 38:22 39:18 40:21 41:15 42:19 43:31 44:23 45:10 46:18 47:12 48:30 49:14 50:15 51:13 52:24 53:17 54:42 55:20 56:30 57:12 58:25 59:16 60:13 61:5 62:3 63:1 64:5 65:1
leeHom,gen_n1000000_l183_merged.fq.gz,1000000,183,999924,999903,21,0.116,0:835733 1:149293 2:13260 3:803 4:37 5:3 8:1 14:1 15:2 16:2 17:1 20:2 21:1 22:5 23:2 24:10 25:1 26:7 27:4 28:9 29:10 30:25 31:23 32:36 33:23 34:23 35:21 36:29 37:6 38:33 39:14 40:15 41:20 42:33 43:33 44:30 45:21 46:22 47:13 48:21 49:20 50:21 51:14 52:31 53:19 54:35 55:18 56:26 57:9 58:16 59:9 60:20 61:10 62:10 63:5 64:11 66:1
leeHom,gen_n1000000_l184_merged.fq.gz,1000000,184,999926,999884,42,0.119,0:832968 1:151564 2:13692 3:826 4:24 5:3 8:1 14:1 15:1 17:1 18:3 19:2 21:1 22:1 23:2 24:2 25:9 26:2 27:8 28:7 29:7 30:11 31:15 32:21 33:18 34:23 35:16 36:25 37:15 38:21 39:15 40:19 41:19 42:38 43:27 44:23 45:12 46:16 47:22 48:25 49:19 50:27 51:21 52:22 53:16 54:26 55:18 56:30 57:17 58:33 59:15 60:32 61:18 62:20 63:13 64:37 65:10 66:2 67:2
leeHom,gen_n1000000_l185_merged.fq.gz,1000000,185,999927,999887,40,0.122,0:830326 1:153524 2:14223 3:893 4:42 6:1 8:1 10:1 12:2 16:1 18:1 19:1 20:3 21:1 22:2 23:2 24:5 25:8 26:8 27:8 28:8 29:6 30:9 31:13 32:19 33:26 34:28 35:31 36:19 37:16 38:22 39:20 40:21 41:18 42:32 43:37 44:28 45:16 46:15 47:16 48:33 49:9 50:25 51:15 52:27 53:18 54:33 55:14 56:23 57:13 58:26 59:10 60:50 61:19 62:19 63:14 64:53 65:29 66:3 67:1
leeHom,gen_n1000000_l186_merged.fq.gz,1000000,186,999915,999874,41,0.125,0:827789 1:155440 2:14725 3:959 4:44 5:4 7:1 10:1 12:1 13:1 14:1 15:3 17:1 18:2 20:2 21:4 22:4 24:3 25:2 26:8 27:5 28:13 29:6 30:4 31:7 32:18 33:24 34:29 35:22 36:23 37:23 38:25 39:17 40:22 41:20 42:34 43:32 44:25 45:13 46:14 47:17 48:32 49:13 50:17 51:13 52:24 53:22 54:28 55:12 56:25 57:17 58:26 59:13 60:42 61:13 62:34 63:17 64:84 65:40 66:11 67:3
leeHom,gen_n1000000_l187_merged.fq.gz,1000000,187,999925,999885,40,0.127,0:825551 1:157393 2:15045 3:889 4:28 5:2 6:2 7:1 8:1 10:1 12:1 14:1 15:2 17:2 18:3 19:2 20:2 21:3 23:2 24:8 26:8 27:5 28:9 29:9 30:16 31:14 32:12 33:11 34:35 35:20 36:23 37:24 38:18 39:21 40:22 41:14 42:29 43:36 44:25 45:16 46:17 47:13 48:14 49:15 50:27 51:27 52:27 53:20 54:26 55:10 56:33 57:20 58:18 59:15 60:49 61:25 62:32 63:27 64:74 65:62 66:15 67:11 68:1 70:1
leeHom,gen_n1000000_l188_merged.fq.gz,1000000,188,999917,999886,31,0.131,0:823211 1:159284 2:15293 3:1007 4:40 5:3 6:1 9:2 13:1 17:2 18:2 19:1 20:3 21:2 22:1 23:1 24:4 25:4 26:5 27:6 28:14 29:10 30:12 31:10 32:10 33:10 34:34 35:21 36:24 37:16 38:22 39:27 40:23 41:20 42:44 43:35 44:25 45:20 46:15 47:12 48:28 49:20 50:18 51:27 52:22 53:23 54:21 55:18 56:28 57:12 58:21 59:14 60:57 61:17 62:27 63:34 64:114 65:57 66:30 67:15 68:4 69:1 70:1
leeHom,gen_n1000000_l189_merged.fq.gz,1000000,189,999930,999863,67,0.131,0:821254 1:161132 2:15392 3:988 4:59 5:1 6:1 8:2 15:3 16:2 17:1 18:1 20:2 21:1 22:4 23:2 24:3 25:4 26:5 27:7 28:17 29:9 30:15 31:11 32:15 33:10 34:22 35:25 36:23 37:14 38:35 39:17 40:23 41:13 42:43 43:48 44:34 45:11 46:15 47:15 48:26 49:14 50:14 51:23 52:24 53:14 54:32 55:16 56:21 57:16 58:22 59:15 60:43 61:23 62:28 63:15 64:104 65:51 66:47 67:16 68:14 69:2 70:3 71:1
leeHom,gen_n1000000_l18_merged.fq.gz,1000000,18,999914,1000000,-86,0.021,0:996155 1:3840 2:5
leeHom,gen_n1000000_l190_merged.fq.gz,1000000,190,999924,999849,75,0.134,0:818193 1:163235 2:16167 3:1116 4:48 5:4 6:1 8:2 15:1 17:1 18:1 19:1 20:5 21:2 22:2 23:2 24:9 25:6 26:2 27:4 28:12 29:10 30:12 31:11 32:9 33:18 34:14 35:15 36:18 37:14 38:25 39:33 40:20 41:20 42:40 43:43 44:36 45:18 46:29 47:15 48:23 49:23 50:17 51:24 52:26 53:23 54:25 55:21 56:24 57:15 58:23 59:10 60:63 61:26 62:26 63:22 64:89 65:70 66:48 67:15 68:12 69:6 70:3 71:1
leeHom,gen_n1000000_l191_merged.fq.gz,1000000,191,999921,999877,44,0.134,0:815893 1:164993 2:16770 3:1097 4:67 5:1 10:1 12:1 16:1 17:1 18:2 19:3 20:2 21:2 22:4 23:2 24:4 25:4 26:4 27:5 28:15 29:7 30:13 31:5 32:14 33:7 34:13 35:19 36:22 37:22 38:26 39:23 40:22 41:13 42:39 43:33 44:24 45:14 46:18 47:21 48:27 49:24 50:20 51:21 52:15 53:17 54:25 55:12 56:38 57:17 58:32 59:21 60:28 61:28 62:18 63:27 64:96 65:57 66:68 67:16 68:25 69:8 70:6 71:2 72:1 74:1
leeHom,gen_n1000000_l192_merged.fq.gz,1000000,192,999907,999859,48,0.138,0:812391 1:167877 2:17211 3:1180 4:63 5:6 8:2 9:2 10:1 11:2 14:1 15:1 17:2 18:3 19:1 20:3 21:2 22:2 23:3 24:7 25:3 26:8 27:5 28:11 29:8 30:21 31:5 32:9 33:3 34:14 35:16 36:22 37:26 38:21 39:22 40:22 41:13 42:42 43:36 44:25 45:15 46:14 47:11 48:21 49:18 50:20 51:21 52:29 53:29 54:32 55:10 56:29 57:14 58:21 59:18 60:38 61:26 62:41 63:26 64:117 65:75 66:54 67:28 68:26 69:7 70:8 71:5 72:5 73:6 74:1 76:1 77:1
leeHom,gen_n1000000_l193_merged.fq.gz,1000000,193,999920,999868,52,0.139,0:811073 1:168992 2:17351 3:1223 4:70 5:2 6:1 9:1 10:2 12:3 15:2 16:2 17:1 18:3 19:1 20:3 21:1 22:2 23:3 24:10 25:6 26:5 27:5 28:8 29:12 30:14 31:9 32:14 33:11 34:12 35:15 36:12 37:16 38:13 39:22 40:21 41:8 42:47 43:53 44:40 45:21 46:16 47:26 48:25 49:15 50:28 51:9 52:21 53:18 54:33 55:14 56:23 57:18 58:31 59:10 60:39 61:21 62:37 63:26 64:107 65:60 66:60 67:25 68:37 69:19 70:18 71:10 72:8 73:1 74:3
leeHom,gen_n1000000_l194_merged.fq.gz,1000000,194,999925,999834,91,0.14,0:809306 1:170135 2:17878 3:1274 4:69 5:3 6:2 10:1 11:1 12:4 13:2 16:2 17:1 18:3 19:1 20:4 21:2 22:1 23:1 24:11 25:6 26:6 27:5 28:6 29:7 30:18 31:16 32:12 33:11 34:14 35:7 36:12 37:21 38:26 39:21 40:26 41:23 42:37 43:39 44:24 45:23 46:20 47:16 48:20 49:20 50:28 51:19 52:28 53:26 54:36 55:13 56:34 57:12 58:23 59:13 60:34 61:21 62:24 63:31 64:108 65:57 66:54 67:25 68:31 69:18 70:25 71:12 72:14 73:5 74:3 75:2 76:1
leeHom,gen_n1000000_l195_merged.fq.gz,1000000,195,999921,999840,81,0.142,0:805809 1:173018 2:18442 3:1310 4:71 5:4 6:1 8:1 10:1 12:1 13:1 14:1 15:3 16:5 18:2 19:1 20:1 21:3 22:3 23:3 24:5 25:2 26:6 27:10 28:12 29:12 30:20 31:10 32:4 33:9 34:10 35:8 36:12 37:10 38:28 39:20 40:25 41:22 42:46 43:48 44:22 45:25 46:13 47:19 48:30 49:28 50:19 51:18 52:20 53:16 54:34 55:11 56:35 57:17 58:39 59:13 60:42 61:17 62:29 63:29 64:112 65:60 66:55 67:10 68:27 69:17 70:26 71:17 72:19 73:4 74:6 75:4 76:4 77:3
leeHom,gen_n1000000_l196_merged.fq.gz,1000000,196,999940,999842,98,0.145,0:802670 1:175526 2:19021 3:1300 4:90 5:7 6:2 7:1 8:2 9:1 10:1 12:5 13:1 14:1 16:2 17:1 18:3 19:1 20:5 21:2 22:2 23:3 24:3 25:7 26:11 27:3 28:9 29:8 30:10 31:5 32:11 33:11 34:9 35:9 36:10 37:18 38:22 39:14 40:21 41:18 42:47 43:54 44:33 45:25 46:13 47:15 48:21 49:19 50:31 51:17 52:23 53:15 54:41 55:18 56:41 57:22 58:19 59:9 60:44 61:19 62:36 63:17 64:115 65:69 66:48 67:19 68:27 69:16 70:29 71:11 72:35 73:17 74:14 75:6 76:5 77:5 79:1
leeHom,gen_n1000000_l197_merged.fq.gz,1000000,197,999919,999806,113,0.147,0:799947 1:177416 2:19702 3:1375 4:86 5:8 6:3 7:1 8:4 9:1 10:1 11:1 12:2 15:2 16:5 17:1 18:4 20:5 21:2 22:3 23:3 24:12 25:7 26:8 27:4 28:12 29:8 30:18 31:6 32:12 33:11 34:10 35:9 36:9 37:13 38:17 39:22 40:25 41:18 42:46 43:55 44:26 45:12 46:17 47:16 48:26 49:22 50:25 51:14 52:30 53:14 54:35 55:11 56:30 57:23 58:27 59:21 60:38 61:21 62:33 63:23 64:100 65:64 66:53 67:26 68:33 69:22 70:31 71:16 72:38 73:13 74:14 75:12 76:13 77:11 78:1 80:1
leeHom,gen_n1000000_l198_merged.fq.gz,1000000,198,999913,999791,122,0.15,0:797678 1:179212 2:20004 3:1465 4:94 5:10 6:1 8:3 10:1 12:4 15:1 16:1 18:2 19:2 20:2 21:5 22:2 23:4 24:12 25:5 26:6 27:4 28:11 29:17 30:8 31:21 32:10 33:10 34:8 35:8 36:12 37:7 38:13 39:15 40:27 41:11 42:52 43:45 44:38 45:26 46:27 47:13 48:10 49:27 50:28 51:24 52:32 53:33 54:27 55:17 56:35 57:19 58:26 59:13 60:44 61:28 62:24 63:32 64:122 65:59 66:37 67:15 68:28 69:10 70:29 71:12 72:54 73:16 74:31 75:21 76:23 77:6 78:8 79:2 80:2
leeHom,gen_n1000000_l199_merged.fq.gz,1000000,199,999921,999803,118,0.149,0:794743 1:181428 2:20707 3:1554 4:105 5:6 6:2 7:1 9:1 10:4 12:2 13:1 14:1 15:3 17:2 18:1 20:3 21:3 22:1 23:1 24:10 25:11 26:6 27:7 28:15 29:8 30:17 31:14 32:14 33:6 34:10 35:4 36:11 37:8 38:25 39:20 40:14 41:20 42:57 43:52 44:27 45:22 46:19 47:17 48:24 49:23 50:22 51:17 52:21 53:15 54:19 55:14 56:32 57:16 58:22 59:14 60:40 61:29 62:37 63:22 64:92 65:65 66:35 67:24 68:28 69:20 70:30 71:16 72:47 73:11 74:23 75:6 76:31 77:8 78:11 79:2 80:2 81:1 82:1
leeHom,gen_n1000000_l19_merged.fq.gz,1000000,19,999898,1000000,-102,0.021,0:995970 1:4022 2:8
leeHom,gen_n1000000_l1_merged.fq.gz,1000000,1,999924,1000000,-76,0.046,0:999542 1:458
leeHom,gen_n1000000_l200_merged.fq.gz,1000000,200,999912,999804,108,0.152,0:792530 1:183058 2:21111 3:1639 4:120 5:12 6:2 8:6 10:2 12:3 15:2 16:1 17:2 18:1 19:2 20:3 21:1 22:5 23:3 24:10 25:7 26:8 27:8 28:15 29:10 30:9 31:5 32:10 33:10 34:8 35:5 36:12 37:13 38:9 39:16 40:27 41:12 42:46 43:43 44:40 45:23 46:23 47:15 48:20 49:22 50:11 51:26 52:31 53:18 54:25 55:13 56:35 57:22 58:34 59:13 60:47 61:25 62:30 63:25 64:105 65:62 66:34 67:25 68:27 69:19 70:33 71:15 72:49 73:20 74:27 75:16 76:33 77:19 78:17 79:7 80:8 81:2 82:1 85:1
leeHom,gen_n1000000_l201_merged.fq.gz,1000000,201,999934,999770,164,0.154,0:789936 1:184955 2:21673 3:1686 4:116 5:9 6:3 7:1 8:3 9:2 10:5 11:2 12:5 14:1 15:1 16:5 18:4 19:4 20:10 21:2 22:1 23:6 24:8 25:9 26:7 27:7 28:16 29:11 30:19 31:8 32:12 33:14 34:11 35:9 36:17 37:11 38:8 39:15 40:25 41:18 42:65 43:55 44:31 45:16 46:14 47:12 48:24 49:27 50:17 51:21 52:20 53:22 54:22 55:16 56:36 57:18 58:24 59:16 60:39 61:24 62:37 63:28 64:124 65:59 66:44 67:17 68:35 69:8 70:34 71:18 72:47 73:12 74:17 75:20 76:25 77:17 78:25 79:9 80:12 81:3 82:4 85:1
leeHom,gen_n1000000_l202_merged.fq.gz,1000000,202,999919,999746,173,0.155,0:786844 1:187721 2:21981 3:1695 4:118 5:13 6:1 8:2 9:1 10:4 11:3 12:4 15:2 16:3 18:1 19:1 20:4 21:1 22:4 23:6 24:9 25:7 26:6 27:3 28:16 29:12 30:18 31:12 32:11 33:10 34:13 35:9 36:13 37:10 38:10 39:13 40:14 41:17 42:58 43:58 44:40 45:22 46:21 47:20 48:20 49:20 50:21 51:27 52:18 53:10 54:38 55:23 56:35 57:25 58:24 59:14 60:31 61:19 62:24 63:30 64:125 65:63 66:31 67:20 68:33 69:13 70:31 71:17 72:40 73:13 74:20 75:17 76:35 77:16 78:30 79:11 80:6 81:6 82:5 83:1 84:2 85:1
leeHom,gen_n1000000_l203_merged.fq.gz,1000000,203,999910,999768,142,0.159,0:783974 1:189569 2:22747 3:1863 4:124 5:16 6:2 8:10 9:1 10:2 11:2 12:3 15:1 16:1 17:2 18:3 19:1 20:6 21:3 22:3 23:3 24:8 25:13 26:7 27:10 28:16 29:8 30:21 31:9 32:13 33:14 34:8 35:10 36:6 37:12 38:10 39:10 40:22 41:21 42:63 43:55 44:41 45:20 46:14 47:26 48:28 49:20 50:19 51:20 52:30 53:19 54:28 55:13 56:37 57:12 58:43 59:18 60:39 61:20 62:34 63:19 64:115 65:72 66:32 67:23 68:39 69:14 70:33 71:21 72:33 73:18 74:20 75:21 76:25 77:20 78:56 79:10 80:18 81:4 82:8 83:4 84:5 85:4 86:1
leeHom,gen_n1000000_l204_merged.fq.gz,1000000,204,999907,999713,194,0.163,0:781083 1:191768 2:23197 3:1986 4:114 5:13 6:3 8:4 9:3 12:3 14:1 15:5 16:3 17:3 18:3 19:3 20:6 21:2 22:5 23:4 24:9 25:5 26:10 27:12 28:7 29:10 30:16 31:8 32:16 33:6 34:17 35:16 36:25 37:10 38:14 39:16 40:9 41:10 42:52 43:61 44:29 45:13 46:29 47:24 48:26 49:25 50:27 51:24 52:32 53:24 54:17 55:22 56:33 57:21 58:32 59:20 60:33 61:24 62:30 63:28 64:135 65:59 66:52 67:23 68:30 69:19 70:38 71:12 72:36 73:18 74:25 75:20 76:21 77:30 78:45 79:12 80:27 81:18 82:17 83:6 84:3 85:11 86:2 87:2 88:1
leeHom,gen_n1000000_l205_merged.fq.gz,1000000,205,999929,999660,269,0.164,0:777934 1:194141 2:23943 3:1914 4:145 5:19 6:4 7:1 8:8 9:2 10:6 12:4 13:2 15:4 16:3 17:5 18:3 20:3 21:5 23:6 24:9 25:7 26:7 27:12 28:16 29:12 30:19 31:13 32:19 33:17 34:20 35:12 36:13 37:16 38:10 39:10 40:15 41:12 42:48 43:56 44:28 45:26 46:26 47:23 48:25 49:19 50:15 51:30 52:29 53:18 54:22 55:21 56:33 57:17 58:31 59:18 60:39 61:19 62:38 63:36 64:109 65:54 66:39 67:33 68:39 69:19 70:35 71:11 72:41 73:20 74:24 75:20 76:26 77:17 78:46 79:10 80:24 81:19 82:18 83:9 84:17 85:11 86:7 87:3 89:1
leeHom,gen_n1000000_l206_merged.fq.gz,1000000,206,999928,999638,290,0.164,0:776121 1:195141 2:24651 3:2023 4:156 5:18 6:4 8:4 9:3 10:1 11:2 12:5 13:2 15:5 16:3 18:3 20:5 21:7 22:2 23:8 24:9 25:8 26:7 27:6 28:19 29:9 30:11 31:13 32:13 33:23 34:20 35:15 36:15 37:9 38:11 39:9 40:13 41:15 42:26 43:47 44:30 45:28 46:18 47:17 48:12 49:30 50:30 51:22 52:23 53:15 54:20 55:11 56:20 57:20 58:26 59:12 60:38 61:29 62:46 63:24 64:140 65:61 66:54 67:22 68:46 69:9 70:23 71:18 72:38 73:11 74:19 75:26 76:30 77:17 78:41 79:17 80:24 81:21 82:21 83:12 84:22 85:18 86:5 87:5 88:2 89:2 90:1
leeHom,gen_n1000000_l207_merged.fq.gz,1000000,207,999924,999636,288,0.169,0:773346 1:197189 2:25184 3:2105 4:130 5:25 6:6 7:2 8:4 9:2 10:3 11:2 12:4 13:2 14:1 15:3 16:3 17:2 18:1 19:4 20:8 21:2 22:7 23:6 24:15 25:9 26:16 27:8 28:17 29:11 30:16 31:9 32:16 33:10 34:11 35:13 36:15 37:14 38:9 39:16 40:18 41:16 42:40 43:47 44:30 45:28 46:29 47:23 48:26 49:34 50:22 51:24 52:20 53:17 54:28 55:13 56:26 57:13 58:25 59:17 60:30 61:22 62:43 63:21 64:126 65:72 66:52 67:19 68:37 69:23 70:25 71:20 72:42 73:12 74:32 75:17 76:22 77:16 78:53 79:21 80:29 81:18 82:18 83:14 84:47 85:27 86:17 87:12 88:3 89:1 90:3
leeHom,gen_n1000000_l208_merged.fq.gz,1000000,208,999926,999609,317,0.172,0:769786 1:200012 2:25742 3:2252 4:124 5:35 6:6 7:1 8:2 9:1 10:8 12:5 13:1 14:1 15:8 16:4 17:5 18:4 19:2 20:3 21:3 22:6 23:4 24:10 25:8 26:9 27:13 28:12 29:10 30:21 31:20 32:12 33:13 34:18 35:9 36:12 37:11 38:13 39:15 40:12 41:12 42:32 43:38 44:25 45:25 46:22 47:19 48:28 49:37 50:31 51:23 52:17 53:13 54:18 55:12 56:27 57:17 58:30 59:19 60:32 61:22 62:38 63:25 64:127 65:61 66:46 67:18 68:27 69:15 70:26 71:19 72:44 73:15 74:22 75:22 76:32 77:25 78:39 79:10 80:24 81:25 82:25 83:9 84:45 85:42 86:46 87:29 88:10 89:3 90:4 91:3 93:1
leeHom,gen_n1000000_l209_merged.fq.gz,1000000,209,999910,999578,332,0.179,0:766607 1:202337 2:26314 3:2300 4:182 5:28 6:5 8:8 10:12 12:5 13:1 15:11 16:3 17:1 18:4 19:1 20:3 21:3 22:6 23:3 24:11 25:9 26:11 27:9 28:14 29:12 30:13 31:17 32:15 33:12 34:19 35:13 36:17 37:9 38:13 39:14 40:11 41:15 42:35 43:25 44:13 45:18 46:24 47:25 48:28 49:29 50:30 51:26 52:32 53:20 54:27 55:11 56:27 57:20 58:30 59:10 60:41 61:21 62:41 63:31 64:124 65:54 66:44 67:21 68:39 69:12 70:40 71:12 72:35 73:13 74:21 75:15 76:46 77:19 78:39 79:15 80:30 81:31 82:26 83:13 84:74 85:62 86:76 87:44 88:22 89:8 90:8 91:1 93:2
leeHom,gen_n1000000_l20_merged.fq.gz,1000000,20,999917,1000000,-83,0.022,0:995574 1:4422 2:4
leeHom,gen_n1000000_l210_merged.fq.gz,1000000,210,999916,999522,394,0.183,0:764283 1:204007 2:26757 3:2294 4:169 5:44 6:8 8:8 9:1 10:8 11:4 12:3 13:2 15:8 16:12 17:2 18:4 19:2 20:11 21:3 22:5 23:3 24:16 25:6 26:14 27:13 28:23 29:10 30:25 31:27 32:18 33:14 34:16 35:12 36:12 37:15 38:15 39:10 40:18 41:12 42:31 43:32 44:21 45:20 46:26 47:32 48:21 49:35 50:30 51:33 52:22 53:21 54:19 55:26 56:22 57:20 58:15 59:10 60:50 61:21 62:42 63:26 64:141 65:72 66:47 67:27 68:29 69:16 70:33 71:18 72:50 73:8 74:32 75:27 76:40 77:14 78:34 79:13 80:31 81:30 82:24 83:14 84:75 85:71 86:79 87:60 88:26 89:10 90:7 91:5
leeHom,gen_n1000000_l211_merged.fq.gz,1000000,211,999931,999489,442,0.182,0:760833 1:206361 2:27705 3:2466 4:184 5:38 6:9 7:3 8:9 9:1 10:19 11:2 12:6 13:1 15:10 16:2 17:2 18:1 19:1 20:10 21:2 22:3 23:5 24:12 25:8 26:6 27:13 28:19 29:12 30:15 31:17 32:21 33:14 34:15 35:10 36:27 37:15 38:22 39:16 40:9 41:11 42:29 43:28 44:18 45:19 46:19 47:27 48:23 49:32 50:28 51:33 52:28 53:19 54:33 55:25 56:26 57:23 58:27 59:22 60:28 61:26 62:34 63:27 64:116 65:48 66:56 67:24 68:36 69:23 70:32 71:13 72:50 73:15 74:30 75:21 76:31 77:17 78:48 79:22 80:26 81:31 82:17 83:12 84:63 85:77 86:67 87:53 88:25 89:6 90:8 91:6 92:4 93:2 94:1
leeHom,gen_n1000000_l212_merged.fq.gz,1000000,212,999910,999445,465,0.183,0:758273 1:208482 2:28057 3:2551 4:165 5:37 6:11 7:1 8:13 9:5 10:14 11:4 12:5 13:1 14:1 15:12 16:3 17:7 18:4 19:1 20:14 21:6 22:6 23:8 24:11 25:8 26:15 27:8 28:18 29:14 30:19 31:12 32:12 33:9 34:11 35:14 36:27 37:6 38:14 39:14 40:16 41:9 42:34 43:26 44:20 45:16 46:20 47:19 48:23 49:16 50:30 51:28 52:16 53:20 54:25 55:14 56:29 57:22 58:10 59:15 60:43 61:23 62:39 63:29 64:130 65:57 66:55 67:32 68:38 69:13 70:35 71:20 72:34 73:12 74:30 75:24 76:35 77:21 78:31 79:13 80:26 81:21 82:18 83:10 84:67 85:81 86:71 87:56 88:26 89:7 90:20 91:8 92:7 93:8 94:1 95:2 97:1
leeHom,gen_n1000000_l213_merged.fq.gz,1000000,213,999900,999450,450,0.186,0:756293 1:209603 2:28639 3:2665 4:201 5:55 6:13 7:1 8:8 9:2 10:18 12:3 13:4 14:1 15:11 16:12 17:2 18:5 19:2 20:9 21:6 22:4 23:6 24:8 25:17 26:14 27:11 28:13 29:19 30:22 31:15 32:16 33:13 34:22 35:18 36:27 37:15 38:14 39:21 40:18 41:24 42:32 43:39 44:14 45:15 46:24 47:13 48:24 49:28 50:27 51:25 52:25 53:22 54:21 55:27 56:30 57:23 58:18 59:14 60:39 61:20 62:35 63:31 64:133 65:48 66:46 67:24 68:32 69:17 70:33 71:18 72:36 73:18 74:24 75:25 76:43 77:22 78:40 79:15 80:26 81:23 82:22 83:12 84:62 85:87 86:58 87:63 88:28 89:14 90:19 91:10 92:14 93:9 94:6 95:4 96:1 97:2
leeHom,gen_n1000000_l214_merged.fq.gz,1000000,214,999937,999365,572,0.19,0:752615 1:211648 2:29994 3:2741 4:211 5:56 6:12 7:2 8:7 9:4 10:21 11:2 12:20 13:2 14:2 15:11 16:13 17:2 18:4 19:4 20:14 21:7 22:3 23:3 24:16 25:12 26:20 27:10 28:18 29:10 30:30 31:16 32:19 33:14 34:17 35:23 36:21 37:10 38:9 39:6 40:27 41:19 42:37 43:35 44:23 45:20 46:21 47:17 48:26 49:23 50:34 51:31 52:26 53:26 54:33 55:29 56:26 57:17 58:15 59:22 60:34 61:21 62:30 63:39 64:109 65:62 66:39 67:21 68:51 69:17 70:23 71:17 72:31 73:22 74:30 75:26 76:47 77:31 78:37 79:9 80:23 81:34 82:34 83:10 84:78 85:75 86:75 87:69 88:32 89:9 90:22 91:19 92:11 93:6 94:5 95:5 96:2 97:3 98:1
leeHom,gen_n1000000_l215_merged.fq.gz,1000000,215,999920,999316,604,0.193,0:749392 1:214098 2:30435 3:2976 4:222 5:62 6:13 7:4 8:15 9:5 10:16 11:8 12:5 13:3 15:17 16:6 17:6 18:5 19:6 20:14 21:10 22:2 23:5 24:12 25:15 26:7 27:10 28:20 29:12 30:26 31:19 32:17 33:7 34:22 35:18 36:19 37:8 38:18 39:15 40:19 41:21 42:38 43:38 44:16 45:18 46:19 47:15 48:20 49:33 50:30 51:33 52:32 53:29 54:24 55:26 56:35 57:20 58:21 59:19 60:25 61:25 62:39 63:33 64:143 65:63 66:48 67:20 68:39 69:15 70:34 71:22 72:51 73:20 74:27 75:26 76:33 77:20 78:35 79:13 80:17 81:21 82:21 83:8 84:65 85:82 86:63 87:70 88:32 89:12 90:47 91:16 92:22 93:11 94:8 95:2 96:1 97:8 98:3
leeHom,gen_n1000000_l216_merged.fq.gz,1000000,216,999907,999282,625,0.194,0:747300 1:215382 2:31175 3:2940 4:227 5:86 6:19 7:2 8:9 9:2 10:20 11:6 12:13 13:2 15:14 16:11 17:5 18:6 19:4 20:21 21:11 22:6 23:8 24:14 25:11 26:17 27:10 28:15 29:12 30:22 31:21 32:13 33:16 34:19 35:17 36:31 37:24 38:21 39:15 40:28 41:20 42:34 43:32 44:10 45:21 46:15 47:14 48:25 49:28 50:27 51:24 52:25 53:21 54:33 55:24 56:35 57:16 58:22 59:12 60:29 61:33 62:30 63:26 64:113 65:74 66:66 67:17 68:33 69:14 70:31 71:16 72:44 73:17 74:21 75:22 76:27 77:20 78:31 79:17 80:30 81:31 82:20 83:10 84:77 85:82 86:85 87:56 88:33 89:10 90:59 91:16 92:13 93:25 94:17 95:8 96:6 97:7 98:2 102:1
leeHom,gen_n1000000_l217_merged.fq.gz,1000000,217,999922,999144,778,0.2,0:743158 1:218025 2:32180 3:3133 4:255 5:58 6:22 7:6 8:11 9:5 10:23 11:4 12:12 13:2 14:1 15:27 16:10 17:5 18:8 19:5 20:20 21:10 22:9 23:9 24:7 25:17 26:22 27:17 28:10 29:5 30:25 31:23 32:22 33:14 34:19 35:13 36:33 37:18 38:9 39:10 40:27 41:20 42:41 43:38 44:23 45:20 46:19 47:16 48:24 49:37 50:41 51:31 52:36 53:22 54:21 55:28 56:24 57:31 58:29 59:21 60:33 61:29 62:40 63:28 64:128 65:58 66:48 67:31 68:36 69:25 70:38 71:19 72:37 73:14 74:21 75:26 76:29 77:17 78:38 79:16 80:28 81:29 82:24 83:11 84:66 85:106 86:74 87:67 88:26 89:10 90:55 91:26 92:26 93:23 94:14 95:10 96:6 97:6 98:10 99:2 100:1 102:2
leeHom,gen_n1000000_l218_merged.fq.gz,1000000,218,999919,999150,769,0.199,0:739878 1:220701 2:32713 3:3237 4:267 5:84 6:16 7:2 8:16 9:2 10:33 11:6 12:14 13:3 14:3 15:24 16:10 17:5 18:5 19:9 20:15 21:10 22:4 23:3 24:18 25:21 26:12 27:14 28:23 29:14 30:27 31:11 32:22 33:23 34:12 35:22 36:33 37:20 38:18 39:13 40:24 41:22 42:39 43:41 44:23 45:21 46:25 47:17 48:23 49:34 50:35 51:34 52:29 53:28 54:33 55:28 56:21 57:19 58:16 59:14 60:33 61:22 62:34 63:31 64:101 65:57 66:50 67:21 68:30 69:11 70:35 71:12 72:53 73:24 74:24 75:25 76:26 77:20 78:34 79:7 80:28 81:27 82:15 83:13 84:80 85:70 86:84 87:55 88:38 89:6 90:54 91:19 92:27 93:16 94:22 95:7 96:12 97:16 98:5 99:8 100:1 101:1 102:6 103:1
leeHom,gen_n1000000_l219_merged.fq.gz,1000000,219,999918,999032,886,0.205,0:737526 1:221824 2:33497 3:3364 4:298 5:91 6:29 7:3 8:12 9:7 10:32 11:8 12:12 13:3 14:2 15:25 16:8 17:7 18:4 19:6 20:26 21:10 22:8 23:11 24:10 25:17 26:14 27:8 28:22 29:15 30:38 31:14 32:28 33:13 34:21 35:20 36:31 37:17 38:17 39:19 40:33 41:15 42:31 43:22 44:21 45:15 46:23 47:18 48:24 49:28 50:29 51:27 52:28 53:32 54:28 55:26 56:33 57:21 58:17 59:16 60:38 61:28 62:41 63:34 64:123 65:55 66:54 67:20 68:52 69:15 70:42 71:17 72:40 73:16 74:27 75:19 76:38 77:24 78:38 79:16 80:33 81:33 82:18 83:9 84:82 85:117 86:77 87:59 88:30 89:12 90:51 91:9 92:32 93:23 94:17 95:14 96:32 97:9 98:11 99:7 100:5 101:4 102:6 103:1
leeHom,gen_n1000000_l21_merged.fq.gz,1000000,21,999934,1000000,-66,0.022,0:995441 1:4556 2:3
leeHom,gen_n1000000_l220_merged.fq.gz,1000000,220,999916,999021,895,0.21,0:734552 1:224209 2:33832 3:3384 4:325 5:93 6:24 7:5 8:14 9:5 10:48 11:13 12:16 13:3 14:2 15:30 16:16 17:4 18:5 19:3 20:29 21:11 22:9 23:12 24:14 25:20 26:22 27:9 28:27 29:22 30:25 31:26 32:25 33:17 34:17 35:30 36:21 37:19 38:18 39:17 40:37 41:19 42:45 43:41 44:25 45:23 46:18 47:21 48:20 49:28 50:45 51:36 52:29 53:30 54:22 55:28 56:23 57:28 58:23 59:16 60:37 61:28 62:28 63:38 64:121 65:57 66:40 67:33 68:41 69:18 70:50 71:22 72:38 73:23 74:33 75:27 76:43 77:18 78:40 79:16 80:23 81:37 82:37 83:14 84:89 85:110 86:87 87:56 88:28 89:8 90:39 91:15 92:20 93:34 94:26 95:16 96:40 97:12 98:19 99:10 100:8 101:3 102:8 104:1
leeHom,gen_n1000000_l221_merged.fq.gz,1000000,221,999924,998874,1050,0.212,0:730919 1:226670 2:34728 3:3548 4:298 5:95 6:26 7:2 8:17 9:4 10:40 11:9 12:13 13:3 14:1 15:32 16:17 17:3 18:3 19:7 20:38 21:14 22:8 23:10 24:15 25:29 26:22 27:26 28:21 29:7 30:26 31:14 32:22 33:13 34:19 35:26 36:29 37:11 38:14 39:16 40:30 41:23 42:40 43:43 44:26 45:16 46:18 47:15 48:23 49:33 50:36 51:33 52:29 53:20 54:31 55:23 56:32 57:17 58:30 59:16 60:50 61:27 62:34 63:39 64:116 65:39 66:39 67:24 68:37 69:15 70:50 71:18 72:34 73:19 74:30 75:23 76:42 77:26 78:41 79:12 80:25 81:30 82:29 83:10 84:94 85:102 86:73 87:74 88:36 89:10 90:32 91:34 92:36 93:31 94:22 95:15 96:54 97:24 98:24 99:20 100:10 101:6 102:12 103:2 104:3 105:2
leeHom,gen_n1000000_l222_merged.fq.gz,1000000,222,999924,998768,1156,0.216,0:727610 1:228881 2:35338 3:3737 4:318 5:101 6:31 7:8 8:22 9:4 10:52 11:14 12:31 13:2 14:2 15:36 16:22 17:10 18:7 19:9 20:37 21:17 22:7 23:8 24:20 25:31 26:16 27:16 28:27 29:19 30:33 31:28 32:23 33:18 34:23 35:26 36:27 37:20 38:11 39:17 40:31 41:31 42:48 43:46 44:23 45:27 46:32 47:9 48:16 49:25 50:28 51:34 52:24 53:26 54:30 55:26 56:29 57:33 58:22 59:17 60:36 61:24 62:39 63:38 64:130 65:59 66:40 67:21 68:43 69:13 70:38 71:24 72:37 73:25 74:29 75:25 76:36 77:35 78:43 79:11 80:38 81:33 82:27 83:14 84:82 85:97 86:91 87:49 88:25 89:19 90:41 91:17 92:23 93:26 94:22 95:22 96:64 97:11 98:19 99:26 100:17 101:13 102:19 103:9 105:1 106:1
leeHom,gen_n1000000_l223_merged.fq.gz,1000000,223,999932,998632,1300,0.222,0:723881 1:230904 2:36618 3:3851 4:343 5:108 6:34 7:6 8:27 9:11 10:53 11:14 12:21 13:6 14:4 15:27 16:26 17:7 18:8 19:1 20:33 21:19 22:4 23:13 24:20 25:22 26:28 27:25 28:26 29:10 30:40 31:18 32:25 33:23 34:16 35:35 36:34 37:15 38:19 39:19 40:26 41:38 42:49 43:53 44:31 45:19 46:24 47:9 48:23 49:25 50:35 51:29 52:26 53:22 54:29 55:20 56:41 57:39 58:24 59:16 60:47 61:31 62:38 63:44 64:120 65:58 66:32 67:33 68:29 69:23 70:38 71:26 72:48 73:20 74:33 75:25 76:34 77:28 78:46 79:15 80:32 81:30 82:33 83:7 84:98 85:111 86:81 87:71 88:48 89:4 90:44 91:26 92:31 93:31 94:16 95:15 96:54 97:16 98:22 99:41 100:28 101:9 102:32 103:4 104:3 105:3 106:2
leeHom,gen_n1000000_l224_merged.fq.gz,1000000,224,999922,998591,1331,0.22,0:722080 1:232306 2:36875 3:3980 4:333 5:123 6:38 7:7 8:26 9:9 10:67 11:11 12:17 13:9 15:35 16:20 17:5 18:14 19:6 20:38 21:15 22:14 23:10 24:17 25:26 26:36 27:17 28:12 29:19 30:43 31:26 32:22 33:15 34:17 35:20 36:29 37:24 38:14 39:18 40:35 41:22 42:50 43:45 44:28 45:28 46:26 47:9 48:22 49:22 50:33 51:44 52:32 53:27 54:33 55:28 56:44 57:26 58:15 59:21 60:38 61:22 62:53 63:29 64:136 65:55 66:39 67:17 68:35 69:19 70:39 71:22 72:35 73:13 74:29 75:23 76:43 77:27 78:36 79:15 80:26 81:26 82:32 83:12 84:95 85:130 86:94 87:68 88:32 89:12 90:49 91:16 92:18 93:34 94:20 95:12 96:51 97:14 98:24 99:31 100:26 101:10 102:23 103:17 104:5 105:3 106:1 107:2
leeHom,gen_n1000000_l225_merged.fq.gz,1000000,225,999911,998431,1480,0.228,0:717449 1:235311 2:37886 3:4167 4:374 5:126 6:39 7:6 8:30 9:6 10:66 11:17 12:23 13:5 14:1 15:46 16:36 17:13 18:11 19:7 20:33 21:12 22:11 23:8 24:23 25:28 26:39 27:19 28:27 29:16 30:37 31:32 32:25 33:22 34:22 35:22 36:32 37:22 38:16 39:10 40:47 41:26 42:65 43:57 44:42 45:38 46:19 47:15 48:20 49:30 50:38 51:24 52:26 53:18 54:28 55:23 56:36 57:22 58:28 59:18 60:37 61:34 62:44 63:29 64:126 65:62 66:48 67:32 68:24 69:22 70:43 71:22 72:31 73:24 74:30 75:22 76:38 77:19 78:52 79:20 80:28 81:29 82:33 83:22 84:89 85:131 86:75 87:55 88:49 89:8 90:49 91:23 92:30 93:20 94:22 95:16 96:50 97:19 98:24 99:28 100:47 101:27 102:50 103:19 104:18 105:6 106:9 107:1
leeHom,gen_n1000000_l226_merged.fq.gz,1000000,226,999920,998318,1602,0.232,0:714697 1:236723 2:38838 3:4313 4:373 5:125 6:36 7:7 8:22 9:18 10:91 11:20 12:21 13:5 14:2 15:47 16:23 17:12 18:4 19:4 20:57 21:22 22:9 23:19 24:22 25:34 26:35 27:23 28:28 29:13 30:40 31:42 32:31 33:23 34:20 35:30 36:31 37:20 38:22 39:12 40:49 41:31 42:52 43:44 44:43 45:34 46:23 47:15 48:21 49:33 50:41 51:24 52:26 53:13 54:34 55:19 56:41 57:28 58:26 59:15 60:44 61:38 62:35 63:47 64:123 65:77 66:37 67:27 68:33 69:13 70:40 71:29 72:43 73:10 74:42 75:32 76:42 77:24 78:34 79:15 80:36 81:32 82:25 83:8 84:94 85:121 86:89 87:68 88:41 89:13 90:47 91:23 92:31 93:22 94:22 95:12 96:70 97:26 98:29 99:31 100:46 101:19 102:42 103:19 104:18 105:9 106:8 107:1 109:1 111:1 112:2 114:1
leeHom,gen_n1000000_l227_merged.fq.gz,1000000,227,999921,998119,1802,0.232,0:711963 1:238009 2:39898 3:4371 4:388 5:154 6:52 7:6 8:47 9:9 10:68 11:24 12:33 13:12 14:2 15:56 16:39 17:9 18:15 19:6 20:58 21:25 22:13 23:14 24:24 25:25 26:36 27:22 28:28 29:27 30:49 31:28 32:36 33:18 34:25 35:37 36:38 37:23 38:18 39:23 40:46 41:26 42:68 43:57 44:43 45:30 46:33 47:21 48:24 49:27 50:43 51:40 52:26 53:18 54:34 55:25 56:36 57:29 58:22 59:19 60:38 61:43 62:34 63:34 64:113 65:47 66:46 67:26 68:25 69:16 70:38 71:32 72:47 73:26 74:33 75:29 76:38 77:16 78:37 79:19 80:37 81:26 82:25 83:18 84:102 85:105 86:89 87:53 88:37 89:11 90:49 91:20 92:27 93:28 94:25 95:15 96:46 97:22 98:34 99:31 100:39 101:16 102:55 103:17 104:13 105:12 106:16 107:3 108:7 109:3 110:2 111:2 112:1 114:1
leeHom,gen_n1000000_l228_merged.fq.gz,1000000,228,999925,998003,1922,0.235,0:707073 1:241204 2:41170 3:4634 4:418 5:138 6:46 7:7 8:45 9:10 10:96 11:23 12:21 13:8 14:4 15:53 16:37 17:10 18:17 19:3 20:58 21:26 22:16 23:18 24:21 25:42 26:49 27:32 28:24 29:11 30:49 31:31 32:26 33:31 34:21 35:37 36:28 37:26 38:26 39:17 40:44 41:35 42:67 43:76 44:37 45:34 46:24 47:15 48:20 49:24 50:38 51:37 52:24 53:15 54:20 55:32 56:47 57:37 58:16 59:17 60:40 61:49 62:34 63:26 64:127 65:48 66:36 67:23 68:27 69:21 70:42 71:16 72:29 73:19 74:31 75:29 76:34 77:18 78:30 79:16 80:24 81:24 82:29 83:17 84:93 85:121 86:78 87:66 88:41 89:17 90:56 91:22 92:38 93:19 94:23 95:17 96:51 97:21 98:28 99:29 100:39 101:17 102:61 103:20 104:20 105:18 106:30 107:6 108:8 109:3 110:1 111:2 113:1 114:1 115:1 117:1
leeHom,gen_n1000000_l229_merged.fq.gz,1000000,229,999915,997792,2123,0.242,0:704614 1:242301 2:41817 3:4825 4:432 5:171 6:50 7:8 8:41 9:18 10:103 11:33 12:31 13:6 14:7 15:74 16:25 17:8 18:13 19:4 20:57 21:24 22:24 23:28 24:23 25:50 26:45 27:25 28:28 29:19 30:47 31:35 32:33 33:22 34:25 35:35 36:45 37:22 38:24 39:16 40:40 41:37 42:58 43:61 44:38 45:36 46:27 47:15 48:26 49:26 50:65 51:45 52:28 53:12 54:28 55:35 56:35 57:36 58:30 59:14 60:51 61:55 62:49 63:40 64:125 65:56 66:43 67:39 68:29 69:21 70:36 71:23 72:44 73:30 74:36 75:21 76:42 77:28 78:43 79:13 80:33 81:28 82:29 83:22 84:106 85:106 86:81 87:66 88:43 89:12 90:55 91:20 92:29 93:30 94:24 95:18 96:43 97:19 98:27 99:40 100:28 101:16 102:73 103:12 104:19 105:27 106:20 107:13 108:10 109:8 110:4 111:1 112:2 113:2 114:2
leeHom,gen_n1000000_l22_merged.fq.gz,1000000,22,999918,1000000,-82,0.021,0:995307 1:4684 2:9
leeHom,gen_n1000000_l230_merged.fq.gz,1000000,230,999909,997650,2259,0.246,0:701708 1:244327 2:42361 3:4763 4:496 5:184 6:62 7:8 8:32 9:13 10:123 11:36 12:31 13:12 14:4 15:75 16:43 17:9 18:6 19:6 20:65 21:25 22:11 23:29 24:28 25:38 26:51 27:21 28:23 29:13 30:67 31:32 32:41 33:30 34:25 35:45 36:52 37:16 38:28 39:17 40:47 41:41 42:74 43:97 44:44 45:30 46:30 47:16 48:42 49:31 50:53 51:39 52:32 53:15 54:34 55:32 56:41 57:32 58:27 59:24 60:45 61:48 62:47 63:33 64:132 65:69 66:48 67:33 68:32 69:16 70:29 71:27 72:43 73:26 74:35 75:21 76:42 77:31 78:34 79:16 80:36 81:38 82:24 83:7 84:96 85:111 86:108 87:70 88:32 89:16 90:44 91:16 92:28 93:29 94:10 95:16 96:56 97:20 98:20 99:44 100:40 101:26 102:54 103:17 104:28 105:30 106:26 107:14 108:18 109:9 110:12 111:3 112:1 113:2 114:4 118:1
leeHom,gen_n1000000_l231_merged.fq.gz,1000000,231,999908,997370,2538,0.251,0:697306 1:247335 2:43017 3:5052 4:520 5:182 6:69 7:5 8:37 9:13 10:120 11:38 12:37 13:11 14:5 15:64 16:52 17:17 18:18 19:9 20:79 21:32 22:16 23:27 24:39 25:66 26:71 27:29 28:35 29:22 30:43 31:39 32:35 33:22 34:32 35:35 36:40 37:21 38:14 39:11 40:42 41:37 42:86 43:86 44:35 45:32 46:34 47:18 48:33 49:38 50:55 51:57 52:44 53:13 54:22 55:28 56:45 57:41 58:28 59:17 60:50 61:35 62:46 63:30 64:150 65:56 66:40 67:34 68:28 69:19 70:42 71:31 72:34 73:20 74:29 75:32 76:51 77:25 78:34 79:5 80:33 81:40 82:27 83:10 84:111 85:114 86:114 87:67 88:34 89:14 90:40 91:27 92:26 93:24 94:24 95:16 96:51 97:21 98:24 99:38 100:49 101:25 102:63 103:21 104:18 105:31 106:21 107:16 108:34 109:10 110:12 111:1 112:4 113:5 114:5 115:3
leeHom,gen_n1000000_l232_merged.fq.gz,1000000,232,999927,997107,2820,0.256,0:694088 1:248888 2:44020 3:5185 4:520 5:210 6:84 7:18 8:47 9:16 10:125 11:32 12:47 13:10 14:7 15:108 16:52 17:17 18:15 19:9 20:85 21:37 22:20 23:30 24:38 25:52 26:53 27:54 28:35 29:18 30:64 31:40 32:27 33:33 34:22 35:43 36:34 37:28 38:21 39:22 40:52 41:42 42:89 43:100 44:48 45:36 46:38 47:16 48:26 49:35 50:54 51:47 52:30 53:13 54:18 55:36 56:41 57:36 58:34 59:15 60:55 61:41 62:49 63:40 64:123 65:68 66:50 67:36 68:28 69:26 70:41 71:27 72:33 73:21 74:30 75:26 76:52 77:28 78:36 79:18 80:34 81:31 82:30 83:7 84:106 85:125 86:117 87:63 88:32 89:8 90:32 91:28 92:36 93:32 94:25 95:22 96:48 97:33 98:19 99:34 100:41 101:22 102:73 103:24 104:24 105:31 106:27 107:10 108:34 109:14 110:17 111:10 112:10 113:8 114:7 115:3 118:1 119:1
leeHom,gen_n1000000_l233_merged.fq.gz,1000000,233,999907,996731,3176,0.265,0:690657 1:250403 2:44894 3:5444 4:596 5:218 6:75 7:17 8:38 9:26 10:132 11:41 12:53 13:11 14:4 15:86 16:72 17:21 18:7 19:15 20:106 21:49 22:16 23:43 24:48 25:61 26:61 27:41 28:37 29:28 30:69 31:50 32:32 33:24 34:20 35:47 36:49 37:30 38:17 39:22 40:63 41:63 42:108 43:90 44:67 45:50 46:57 47:24 48:23 49:43 50:61 51:39 52:30 53:21 54:19 55:32 56:47 57:36 58:28 59:12 60:41 61:45 62:49 63:41 64:121 65:85 66:42 67:23 68:37 69:19 70:45 71:36 72:29 73:14 74:33 75:28 76:59 77:35 78:44 79:12 80:41 81:31 82:36 83:16 84:115 85:137 86:102 87:67 88:35 89:13 90:44 91:29 92:35 93:28 94:25 95:26 96:63 97:17 98:30 99:39 100:50 101:25 102:49 103:21 104:20 105:35 106:35 107:11 108:55 109:18 110:19 111:11 112:20 113:6 114:6 115:6 117:1 118:1 119:2
leeHom,gen_n1000000_l234_merged.fq.gz,1000000,234,999922,996371,3551,0.268,0:686315 1:252881 2:46182 3:5579 4:568 5:218 6:75 7:12 8:59 9:30 10:137 11:41 12:59 13:14 14:6 15:104 16:46 17:22 18:14 19:12 20:69 21:42 22:21 23:42 24:51 25:49 26:72 27:43 28:33 29:24 30:79 31:50 32:33 33:20 34:26 35:58 36:41 37:26 38:32 39:21 40:71 41:50 42:104 43:118 44:62 45:44 46:41 47:30 48:39 49:39 50:73 51:65 52:43 53:14 54:21 55:42 56:45 57:26 58:27 59:25 60:60 61:58 62:63 63:39 64:118 65:53 66:64 67:39 68:26 69:31 70:45 71:48 72:43 73:12 74:23 75:27 76:44 77:28 78:40 79:16 80:33 81:37 82:30 83:18 84:108 85:133 86:107 87:72 88:30 89:9 90:36 91:29 92:36 93:27 94:25 95:14 96:47 97:22 98:28 99:39 100:48 101:22 102:69 103:28 104:30 105:32 106:25 107:21 108:47 109:25 110:19 111:22 112:15 113:10 114:6 115:5 116:3 117:1 119:1
leeHom,gen_n1000000_l235_merged.fq.gz,1000000,235,999915,996004,3911,0.273,0:683801 1:253890 2:46746 3:5776 4:637 5:257 6:93 7:13 8:51 9:21 10:178 11:59 12:58 13:17 14:13 15:119 16:56 17:25 18:17 19:11 20:96 21:52 22:17 23:41 24:55 25:85 26:80 27:35 28:31 29:23 30:98 31:47 32:41 33:28 34:26 35:54 36:48 37:29 38:23 39:21 40:59 41:50 42:96 43:116 44:60 45:51 46:46 47:29 48:25 49:43 50:84 51:45 52:41 53:23 54:27 55:49 56:51 57:49 58:27 59:26 60:54 61:44 62:51 63:29 64:125 65:69 66:48 67:27 68:30 69:24 70:46 71:43 72:43 73:27 74:26 75:27 76:49 77:48 78:50 79:8 80:38 81:32 82:42 83:13 84:95 85:113 86:104 87:64 88:35 89:17 90:54 91:31 92:32 93:29 94:29 95:18 96:57 97:25 98:42 99:39 100:51 101:20 102:56 103:18 104:30 105:35 106:41 107:16 108:58 109:18 110:16 111:22 112:26 113:13 114:18 115:8 116:3 117:4 118:5 119:3 120:1
leeHom,gen_n1000000_l236_merged.fq.gz,1000000,236,999917,995512,4405,0.28,0:679317 1:256134 2:47960 3:5927 4:653 5:316 6:96 7:25 8:56 9:30 10:173 11:41 12:54 13:15 14:6 15:119 16:74 17:17 18:18 19:14 20:124 21:60 22:26 23:63 24:78 25:64 26:106 27:64 28:41 29:24 30:89 31:68 32:36 33:36 34:29 35:62 36:49 37:35 38:22 39:20 40:68 41:53 42:141 43:126 44:89 45:49 46:43 47:24 48:32 49:61 50:75 51:66 52:39 53:17 54:21 55:37 56:58 57:28 58:28 59:22 60:61 61:46 62:52 63:40 64:126 65:73 66:53 67:31 68:36 69:27 70:51 71:29 72:39 73:20 74:26 75:20 76:52 77:28 78:29 79:12 80:32 81:29 82:39 83:11 84:102 85:136 86:91 87:64 88:39 89:12 90:57 91:40 92:20 93:33 94:24 95:22 96:62 97:23 98:32 99:52 100:34 101:37 102:69 103:33 104:21 105:41 106:29 107:19 108:65 109:20 110:23 111:19 112:42 113:17 114:18 115:13 116:6 117:5 118:4 119:3 120:3 123:1 124:1
leeHom,gen_n1000000_l237_merged.fq.gz,1000000,237,999921,994925,4996,0.288,0:675442 1:257641 2:48978 3:6245 4:721 5:325 6:106 7:29 8:64 9:26 10:225 11:70 12:79 13:18 14:10 15:150 16:94 17:18 18:26 19:14 20:152 21:54 22:26 23:42 24:55 25:68 26:114 27:69 28:35 29:21 30:86 31:66 32:42 33:30 34:26 35:65 36:55 37:32 38:30 39:18 40:58 41:55 42:144 43:151 44:76 45:58 46:49 47:27 48:35 49:73 50:98 51:66 52:41 53:18 54:22 55:40 56:56 57:40 58:25 59:21 60:62 61:54 62:47 63:40 64:130 65:60 66:57 67:35 68:33 69:29 70:49 71:40 72:37 73:20 74:22 75:22 76:31 77:28 78:33 79:16 80:35 81:36 82:45 83:19 84:129 85:149 86:99 87:74 88:40 89:19 90:46 91:25 92:29 93:41 94:29 95:23 96:80 97:22 98:36 99:49 100:35 101:31 102:48 103:29 104:39 105:34 106:32 107:24 108:58 109:13 110:24 111:28 112:51 113:14 114:29 115:15 116:15 117:4 118:4 119:2 120:2 121:2 122:2
leeHom,gen_n1000000_l238_merged.fq.gz,1000000,238,999925,994494,5431,0.289,0:672324 1:259585 2:49420 3:6445 4:713 5:356 6:127 7:29 8:72 9:39 10:199 11:71 12:61 13:37 14:9 15:161 16:80 17:32 18:25 19:10 20:146 21:62 22:31 23:54 24:56 25:74 26:99 27:58 28:49 29:27 30:95 31:73 32:48 33:34 34:31 35:66 36:56 37:34 38:30 39:24 40:70 41:66 42:149 43:143 44:76 45:57 46:61 47:18 48:34 49:58 50:81 51:60 52:46 53:17 54:29 55:55 56:53 57:34 58:24 59:17 60:55 61:55 62:55 63:45 64:134 65:52 66:52 67:34 68:27 69:28 70:55 71:45 72:48 73:26 74:25 75:35 76:47 77:31 78:31 79:19 80:41 81:39 82:41 83:12 84:121 85:136 86:111 87:70 88:40 89:20 90:60 91:17 92:29 93:37 94:22 95:19 96:51 97:33 98:32 99:38 100:36 101:24 102:61 103:33 104:26 105:37 106:27 107:19 108:52 109:14 110:19 111:29 112:38 113:14 114:37 115:21 116:17 117:11 118:8 119:4 120:4 121:2 122:2 126:1
leeHom,gen_n1000000_l239_merged.fq.gz,1000000,239,999926,992741,7185,0.299,0:667726 1:260443 2:50660 3:6583 4:723 5:401 6:150 7:45 8:63 9:45 10:217 11:82 12:92 13:31 14:10 15:200 16:109 17:26 18:25 19:9 20:156 21:74 22:38 23:79 24:81 25:90 26:107 27:84 28:43 29:37 30:102 31:80 32:50 33:27 34:35 35:55 36:58 37:44 38:32 39:18 40:87 41:73 42:160 43:191 44:76 45:64 46:51 47:38 48:41 49:62 50:112 51:69 52:51 53:20 54:23 55:53 56:68 57:33 58:32 59:20 60:66 61:49 62:55 63:39 64:143 65:77 66:60 67:37 68:30 69:44 70:54 71:33 72:44 73:26 74:28 75:30 76:43 77:30 78:36 79:12 80:33 81:48 82:30 83:21 84:98 85:145 86:132 87:54 88:48 89:15 90:55 91:22 92:30 93:28 94:26 95:19 96:43 97:38 98:27 99:37 100:48 101:16 102:78 103:28 104:17 105:27 106:26 107:11 108:58 109:13 110:21 111:27 112:47 113:12 114:69 115:16 116:20 117:20 118:16 119:4 120:9 121:7 123:2 124:4 125:1 126:4 127:1
leeHom,gen_n1000000_l23_merged.fq.gz,1000000,23,999913,1000000,-87,0.021,0:995136 1:4854 2:10
leeHom,gen_n1000000_l240_merged.fq.gz,1000000,240,999921,14988,984933,13.451,1:673 2:857 3:576 4:736 5:1309 6:707 7:246 8:170 9:106 10:465 11:199 12:117 13:65 14:52 15:379 16:271 17:92 18:60 19:36 20:267 21:142 22:56 23:168 24:142 25:157 26:274 27:209 28:114 29:56 30:170 31:121 32:81 33:52 34:45 35:78 36:81 37:65 38:44 39:23 40:118 41:111 42:301 43:422 44:268 45:157 46:85 47:48 48:59 49:127 50:182 51:163 52:97 53:50 54:30 55:63 56:98 57:56 58:42 59:14 60:75 61:75 62:82 63:60 64:136 65:81 66:54 67:50 68:45 69:44 70:62 71:64 72:62 73:33 74:34 75:44 76:46 77:38 78:34 79:21 80:59 81:32 82:45 83:27 84:121 85:176 86:143 87:101 88:63 89:23 90:53 91:30 92:45 93:36 94:20 95:23 96:65 97:33 98:53 99:61 100:54 101:29 102:61 103:32 104:31 105:44 106:32 107:22 108:50 109:19 110:30 111:30 112:48 113:12 114:48 115:17 116:24 117:29 118:15 119:12 120:22 121:14 122:2 123:6 126:2 127:1 128:1
leeHom,gen_n1000000_l241_merged.fq.gz,1000000,241,999922,15155,984767,13.791,2:1041 3:652 4:831 5:1372 6:703 7:283 8:262 9:117 10:455 11:258 12:145 13:46 14:51 15:395 16:264 17:84 18:56 19:40 20:245 21:164 22:68 23:182 24:155 25:184 26:269 27:225 28:105 29:45 30:170 31:108 32:97 33:36 34:48 35:78 36:95 37:70 38:41 39:37 40:111 41:106 42:312 43:405 44:271 45:114 46:96 47:39 48:54 49:165 50:205 51:139 52:98 53:46 54:41 55:74 56:100 57:62 58:41 59:18 60:62 61:90 62:84 63:49 64:146 65:72 66:67 67:48 68:54 69:47 70:79 71:55 72:59 73:30 74:33 75:39 76:58 77:49 78:41 79:18 80:40 81:33 82:48 83:32 84:132 85:184 86:150 87:98 88:60 89:21 90:49 91:41 92:35 93:43 94:26 95:24 96:61 97:25 98:48 99:65 100:70 101:43 102:62 103:27 104:38 105:38 106:42 107:22 108:47 109:17 110:24 111:26 112:42 113:21 114:55 115:27 116:38 117:35 118:26 119:15 120:24 121:12 122:11 123:2 124:6 125:3 126:6 127:6 129:1
leeHom,gen_n1000000_l242_merged.fq.gz,1000000,242,999910,15141,984769,14.04,3:654 4:1235 5:1613 6:778 7:312 8:240 9:152 10:479 11:221 12:155 13:91 14:48 15:399 16:256 17:116 18:78 19:40 20:287 21:153 22:68 23:176 24:161 25:188 26:317 27:190 28:105 29:57 30:185 31:132 32:82 33:45 34:56 35:83 36:104 37:64 38:38 39:37 40:118 41:120 42:332 43:391 44:258 45:130 46:108 47:51 48:48 49:128 50:213 51:147 52:87 53:34 54:37 55:96 56:102 57:74 58:31 59:10 60:62 61:101 62:82 63:47 64:153 65:65 66:83 67:52 68:42 69:47 70:69 71:68 72:62 73:33 74:27 75:27 76:64 77:37 78:27 79:17 80:37 81:55 82:37 83:19 84:130 85:189 86:178 87:101 88:66 89:16 90:54 91:41 92:49 93:42 94:38 95:23 96:63 97:31 98:60 99:55 100:55 101:36 102:57 103:46 104:50 105:41 106:43 107:19 108:51 109:21 110:19 111:24 112:46 113:26 114:43 115:18 116:31 117:31 118:23 119:16 120:30 121:13 122:7 123:5 124:8 125:3 126:10 127:5 128:1 129:2 130:2
leeHom,gen_n1000000_l243_merged.fq.gz,1000000,243,999926,15233,984693,14.106,4:1340 5:1795 6:913 7:326 8:290 9:152 10:548 11:220 12:197 13:76 14:42 15:422 16:294 17:120 18:62 19:45 20:317 21:146 22:65 23:201 24:161 25:184 26:359 27:177 28:104 29:61 30:221 31:116 32:67 33:40 34:43 35:99 36:99 37:64 38:59 39:29 40:121 41:109 42:340 43:447 44:245 45:144 46:105 47:56 48:46 49:141 50:200 51:115 52:94 53:41 54:38 55:85 56:111 57:60 58:37 59:21 60:76 61:74 62:69 63:61 64:144 65:83 66:64 67:48 68:49 69:48 70:95 71:56 72:53 73:37 74:37 75:46 76:49 77:36 78:33 79:22 80:36 81:41 82:49 83:29 84:152 85:153 86:156 87:82 88:45 89:17 90:46 91:35 92:48 93:33 94:22 95:17 96:67 97:36 98:69 99:68 100:52 101:32 102:87 103:29 104:34 105:42 106:23 107:21 108:53 109:18 110:23 111:33 112:56 113:17 114:52 115:28 116:42 117:29 118:26 119:13 120:48 121:19 122:17 123:12 124:11 125:4 126:5 127:6 128:6 129:4
leeHom,gen_n1000000_l244_merged.fq.gz,1000000,244,999921,14662,985259,14.78,5:1575 6:1259 7:494 8:482 9:241 10:546 11:236 12:192 13:83 14:55 15:471 16:301 17:84 18:82 19:43 20:328 21:152 22:82 23:187 24:175 25:183 26:335 27:219 28:100 29:53 30:192 31:142 32:95 33:45 34:44 35:81 36:120 37:66 38:48 39:45 40:132 41:90 42:367 43:435 44:257 45:131 46:102 47:41 48:41 49:151 50:194 51:136 52:111 53:38 54:26 55:95 56:119 57:64 58:47 59:15 60:72 61:82 62:65 63:42 64:131 65:72 66:83 67:54 68:40 69:43 70:82 71:67 72:65 73:39 74:29 75:48 76:51 77:36 78:26 79:23 80:52 81:42 82:44 83:29 84:143 85:179 86:154 87:104 88:42 89:23 90:38 91:31 92:44 93:33 94:22 95:32 96:77 97:36 98:40 99:60 100:45 101:42 102:74 103:22 104:38 105:31 106:40 107:29 108:56 109:13 110:22 111:32 112:40 113:15 114:47 115:23 116:36 117:39 118:31 119:17 120:44 121:26 122:21 123:17 124:14 125:9 126:13 127:10 128:8 129:5
leeHom,gen_n1000000_l245_merged.fq.gz,1000000,245,999908,14048,985860,16.226,6:868 7:521 8:546 9:237 10:982 11:422 12:236 13:109 14:58 15:498 16:272 17:126 18:82 19:52 20:370 21:197 22:74 23:215 24:185 25:212 26:334 27:210 28:100 29:44 30:187 31:138 32:100 33:57 34:63 35:125 36:128 37:84 38:58 39:49 40:133 41:119 42:341 43:423 44:243 45:136 46:101 47:66 48:60 49:166 50:214 51:155 52:80 53:40 54:43 55:105 56:109 57:65 58:47 59:28 60:79 61:88 62:60 63:38 64:151 65:75 66:89 67:57 68:47 69:44 70:75 71:67 72:74 73:29 74:32 75:54 76:48 77:46 78:33 79:16 80:41 81:53 82:55 83:25 84:151 85:170 86:147 87:90 88:57 89:27 90:46 91:42 92:49 93:36 94:22 95:30 96:65 97:37 98:51 99:50 100:64 101:53 102:66 103:40 104:29 105:39 106:41 107:21 108:46 109:30 110:23 111:41 112:54 113:15 114:29 115:22 116:39 117:31 118:25 119:18 120:76 121:26 122:32 123:27 124:27 125:10 126:19 127:12 128:18 129:11 130:2 131:2 132:1
leeHom,gen_n1000000_l246_merged.fq.gz,1000000,246,999926,14036,985890,16.567,7:432 8:832 9:436 10:1051 11:443 12:317 13:127 14:93 15:549 16:286 17:139 18:82 19:63 20:342 21:158 22:91 23:232 24:195 25:214 26:409 27:249 28:104 29:58 30:230 31:158 32:85 33:58 34:48 35:122 36:132 37:69 38:61 39:37 40:127 41:115 42:365 43:408 44:232 45:137 46:117 47:64 48:46 49:165 50:228 51:139 52:103 53:48 54:41 55:86 56:117 57:66 58:33 59:12 60:77 61:81 62:58 63:48 64:109 65:71 66:89 67:64 68:47 69:39 70:86 71:72 72:64 73:40 74:34 75:40 76:55 77:49 78:31 79:22 80:41 81:55 82:35 83:28 84:144 85:151 86:154 87:81 88:64 89:19 90:53 91:43 92:33 93:44 94:22 95:24 96:72 97:47 98:64 99:67 100:53 101:42 102:71 103:32 104:34 105:41 106:32 107:21 108:55 109:21 110:30 111:27 112:45 113:24 114:41 115:20 116:41 117:37 118:16 119:21 120:89 121:32 122:25 123:28 124:26 125:12 126:33 127:35 128:48 129:19 130:10 131:4 132:2 134:1
leeHom,gen_n1000000_l247_merged.fq.gz,1000000,247,999918,14143,985775,16.863,8:838 9:515 10:1148 11:480 12:276 13:142 14:100 15:548 16:336 17:144 18:103 19:56 20:405 21:218 22:98 23:276 24:199 25:205 26:419 27:223 28:110 29:55 30:230 31:134 32:73 33:54 34:43 35:106 36:110 37:87 38:59 39:39 40:125 41:129 42:393 43:419 44:238 45:141 46:130 47:52 48:52 49:181 50:198 51:155 52:103 53:37 54:39 55:98 56:120 57:71 58:39 59:11 60:86 61:90 62:64 63:28 64:102 65:68 66:93 67:55 68:51 69:57 70:71 71:65 72:71 73:27 74:32 75:49 76:50 77:42 78:37 79:17 80:55 81:59 82:30 83:22 84:144 85:170 86:147 87:88 88:45 89:21 90:59 91:45 92:46 93:36 94:28 95:18 96:75 97:42 98:63 99:57 100:62 101:36 102:88 103:42 104:31 105:41 106:57 107:24 108:49 109:23 110:30 111:31 112:45 113:22 114:38 115:16 116:26 117:32 118:21 119:19 120:78 121:24 122:23 123:36 124:19 125:12 126:41 127:59 128:96 129:39 130:15 131:1 132:2
leeHom,gen_n1000000_l248_merged.fq.gz,1000000,248,999911,14188,985723,17.473,9:390 10:1448 11:595 12:412 13:178 14:117 15:582 16:382 17:125 18:107 19:68 20:449 21:227 22:116 23:312 24:180 25:227 26:429 27:210 28:124 29:65 30:216 31:154 32:82 33:54 34:61 35:114 36:113 37:70 38:70 39:41 40:131 41:130 42:374 43:413 44:211 45:126 46:111 47:56 48:69 49:172 50:217 51:168 52:100 53:45 54:60 55:96 56:110 57:78 58:42 59:25 60:84 61:103 62:67 63:33 64:83 65:72 66:72 67:64 68:44 69:63 70:98 71:67 72:71 73:41 74:29 75:40 76:64 77:45 78:31 79:17 80:42 81:45 82:35 83:26 84:125 85:178 86:131 87:89 88:55 89:19 90:58 91:49 92:52 93:24 94:23 95:27 96:70 97:40 98:62 99:59 100:61 101:28 102:59 103:25 104:40 105:48 106:32 107:30 108:60 109:22 110:23 111:29 112:49 113:19 114:52 115:14 116:40 117:32 118:19 119:10 120:73 121:24 122:30 123:42 124:38 125:16 126:68 127:81 128:168 129:64 130:28 131:7 132:3 133:1 134:2 135:1 136:1
leeHom,gen_n1000000_l249_merged.fq.gz,1000000,249,999912,14503,985409,18.067,10:1482 11:672 12:478 13:221 14:152 15:685 16:373 17:155 18:133 19:80 20:421 21:227 22:96 23:322 24:216 25:271 26:409 27:213 28:96 29:65 30:256 31:140 32:85 33:50 34:51 35:121 36:123 37:79 38:64 39:48 40:142 41:137 42:379 43:409 44:190 45:134 46:118 47:64 48:62 49:188 50:233 51:151 52:82 53:30 54:38 55:106 56:146 57:73 58:42 59:20 60:82 61:92 62:81 63:27 64:47 65:46 66:91 67:46 68:57 69:49 70:92 71:77 72:64 73:34 74:39 75:73 76:75 77:49 78:39 79:26 80:57 81:46 82:51 83:19 84:99 85:154 86:107 87:71 88:39 89:16 90:51 91:49 92:49 93:19 94:25 95:31 96:63 97:35 98:67 99:60 100:60 101:48 102:79 103:37 104:34 105:46 106:43 107:22 108:62 109:11 110:22 111:41 112:65 113:22 114:54 115:18 116:36 117:33 118:27 119:18 120:89 121:26 122:29 123:31 124:34 125:13 126:128 127:105 128:233 129:132 130:43 131:23 132:8 133:4 134:3 136:2
leeHom,gen_n1000000_l24_merged.fq.gz,1000000,24,999929,1000000,-71,0.021,0:994872 1:5118 2:10
leeHom,gen_n1000000_l250_merged.fq.gz,1000000,250,999916,13966,985950,19.827,11:238 12:677 13:332 14:182 15:851 16:510 17:204 18:150 19:79 20:490 21:231 22:123 23:320 24:242 25:301 26:442 27:238 28:130 29:60 30:248 31:156 32:80 33:69 34:61 35:173 36:137 37:75 38:52 39:36 40:168 41:134 42:376 43:400 44:198 45:132 46:133 47:50 48:59 49:181 50:237 51:182 52:107 53:36 54:42 55:101 56:124 57:86 58:34 59:19 60:95 61:95 62:87 63:33 64:45 65:46 66:88 67:70 68:58 69:52 70:93 71:64 72:71 73:44 74:35 75:62 76:66 77:46 78:37 79:23 80:35 81:51 82:37 83:20 84:91 85:129 86:121 87:79 88:39 89:21 90:59 91:45 92:42 93:26 94:24 95:32 96:72 97:38 98:69 99:60 100:44 101:41 102:90 103:42 104:41 105:34 106:63 107:21 108:61 109:15 110:29 111:33 112:53 113:24 114:39 115:17 116:34 117:20 118:29 119:23 120:75 121:36 122:42 123:35 124:37 125:16 126:128 127:159 128:338 129:202 130:113 131:27 132:10 133:2 134:4 135:1 137:1 138:1
leeHom,gen_n1000000_l25_merged.fq.gz,1000000,25,999922,999998,-76,0.022,0:994635 1:5349 2:14
leeHom,gen_n1000000_l26_merged.fq.gz,1000000,26,999912,1000000,-88,0.021,0:994542 1:5444 2:14
leeHom,gen_n1000000_l27_merged.fq.gz,1000000,27,999930,1000000,-70,0.021,0:994385 1:5602 2:13
leeHom,gen_n1000000_l28_merged.fq.gz,1000000,28,999922,1000000,-78,0.021,0:994045 1:5933 2:21 3:1
leeHom,gen_n1000000_l29_merged.fq.gz,1000000,29,999909,1000000,-91,0.021,0:993939 1:6045 2:16
leeHom,gen_n1000000_l2_merged.fq.gz,1000000,2,999928,1000000,-72,0.046,0:999086 1:913 2:1
leeHom,gen_n1000000_l30_merged.fq.gz,1000000,30,999937,1000000,-63,0.021,0:993818 1:6165 2:17
leeHom,gen_n1000000_l31_merged.fq.gz,1000000,31,999928,1000000,-72,0.021,0:993374 1:6604 2:22
leeHom,gen_n1000000_l32_merged.fq.gz,1000000,32,999921,999999,-78,0.021,0:993247 1:6731 2:21
leeHom,gen_n1000000_l33_merged.fq.gz,1000000,33,999929,1000000,-71,0.021,0:993154 1:6832 2:14
leeHom,gen_n1000000_l34_merged.fq.gz,1000000,34,999934,1000000,-66,0.021,0:992888 1:7084 2:28
leeHom,gen_n1000000_l35_merged.fq.gz,1000000,35,999903,1000000,-97,0.021,0:992662 1:7319 2:19
leeHom,gen_n1000000_l36_merged.fq.gz,1000000,36,999918,1000000,-82,0.021,0:992587 1:7389 2:24
leeHom,gen_n1000000_l37_merged.fq.gz,1000000,37,999921,1000000,-79,0.021,0:992199 1:7768 2:33
leeHom,gen_n1000000_l38_merged.fq.gz,1000000,38,999917,1000000,-83,0.021,0:991931 1:8045 2:24
leeHom,gen_n1000000_l39_merged.fq.gz,1000000,39,999919,1000000,-81,0.021,0:991676 1:8295 2:29
leeHom,gen_n1000000_l3_merged.fq.gz,1000000,3,999926,1000000,-74,0.047,0:998603 1:1397
leeHom,gen_n1000000_l40_merged.fq.gz,1000000,40,999920,1000000,-80,0.021,0:991768 1:8200 2:32
leeHom,gen_n1000000_l41_merged.fq.gz,1000000,41,999900,1000000,-100,0.021,0:991220 1:8750 2:30
leeHom,gen_n1000000_l42_merged.fq.gz,1000000,42,999906,999999,-93,0.021,0:991203 1:8764 2:32
leeHom,gen_n1000000_l43_merged.fq.gz,1000000,43,999921,1000000,-79,0.021,0:991051 1:8908 2:41
leeHom,gen_n1000000_l44_merged.fq.gz,1000000,44,999910,999999,-89,0.021,0:990856 1:9096 2:47
leeHom,gen_n1000000_l45_merged.fq.gz,1000000,45,999912,1000000,-88,0.021,0:990475 1:9479 2:46
leeHom,gen_n1000000_l46_merged.fq.gz,1000000,46,999923,999999,-76,0.021,0:990349 1:9596 2:53 3:1
leeHom,gen_n1000000_l47_merged.fq.gz,1000000,47,999928,1000000,-72,0.021,0:990215 1:9738 2:47
leeHom,gen_n1000000_l48_merged.fq.gz,1000000,48,999923,1000000,-77,0.021,0:989756 1:10185 2:59
leeHom,gen_n1000000_l49_merged.fq.gz,1000000,49,999925,1000000,-75,0.021,0:989779 1:10176 2:45
leeHom,gen_n1000000_l4_merged.fq.gz,1000000,4,999896,1000000,-104,0.044,0:998247 1:1751 2:2
leeHom,gen_n1000000_l50_merged.fq.gz,1000000,50,999927,1000000,-73,0.022,0:989285 1:10651 2:64
leeHom,gen_n1000000_l51_merged.fq.gz,1000000,51,999919,1000000,-81,0.021,0:989500 1:10454 2:46
leeHom,gen_n1000000_l52_merged.fq.gz,1000000,52,999920,1000000,-80,0.021,0:988898 1:11040 2:62
leeHom,gen_n1000000_l53_merged.fq.gz,1000000,53,999912,1000000,-88,0.021,0:988915 1:11014 2:71
leeHom,gen_n1000000_l54_merged.fq.gz,1000000,54,999922,1000000,-78,0.021,0:988808 1:11128 2:64
leeHom,gen_n1000000_l55_merged.fq.gz,1000000,55,999914,1000000,-86,0.021,0:988420 1:11519 2:59 3:2
leeHom,gen_n1000000_l56_merged.fq.gz,1000000,56,999916,1000000,-84,0.021,0:988171 1:11769 2:60
leeHom,gen_n1000000_l57_merged.fq.gz,1000000,57,999900,1000000,-100,0.021,0:987977 1:11955 2:67 3:1
leeHom,gen_n1000000_l58_merged.fq.gz,1000000,58,999915,1000000,-85,0.021,0:987716 1:12222 2:62
leeHom,gen_n1000000_l59_merged.fq.gz,1000000,59,999905,1000000,-95,0.021,0:987522 1:12396 2:82
leeHom,gen_n1000000_l5_merged.fq.gz,1000000,5,999925,1000000,-75,0.045,0:997760 1:2240
leeHom,gen_n1000000_l60_merged.fq.gz,1000000,60,999917,1000000,-83,0.021,0:987364 1:12575 2:60 3:1
leeHom,gen_n1000000_l61_merged.fq.gz,1000000,61,999918,1000000,-82,0.021,0:987239 1:12685 2:76
leeHom,gen_n1000000_l62_merged.fq.gz,1000000,62,999910,1000000,-90,0.021,0:987138 1:12780 2:80 3:2
leeHom,gen_n1000000_l63_merged.fq.gz,1000000,63,999911,1000000,-89,0.021,0:986958 1:12950 2:92
leeHom,gen_n1000000_l64_merged.fq.gz,1000000,64,999922,1000000,-78,0.021,0:986374 1:13541 2:85
leeHom,gen_n1000000_l65_merged.fq.gz,1000000,65,999920,1000000,-80,0.021,0:986184 1:13717 2:99
leeHom,gen_n1000000_l66_merged.fq.gz,1000000,66,999904,1000000,-96,0.021,0:986119 1:13769 2:112
leeHom,gen_n1000000_l67_merged.fq.gz,1000000,67,999925,1000000,-75,0.021,0:985924 1:13978 2:98
leeHom,gen_n1000000_l68_merged.fq.gz,1000000,68,999915,1000000,-85,0.021,0:985635 1:14258 2:106 3:1
leeHom,gen_n1000000_l69_merged.fq.gz,1000000,69,999916,1000000,-84,0.021,0:985576 1:14331 2:93
leeHom,gen_n1000000_l6_merged.fq.gz,1000000,6,999916,1000000,-84,0.037,0:997752 1:2246 2:2
leeHom,gen_n1000000_l70_merged.fq.gz,1000000,70,999901,1000000,-99,0.021,0:985153 1:14740 2:107
leeHom,gen_n1000000_l71_merged.fq.gz,1000000,71,999895,1000000,-105,0.022,0:984790 1:15092 2:118
leeHom,gen_n1000000_l72_merged.fq.gz,1000000,72,999909,1000000,-91,0.022,0:984336 1:15557 2:107
leeHom,gen_n1000000_l73_merged.fq.gz,1000000,73,999926,1000000,-74,0.022,0:984378 1:15496 2:124 3:2
leeHom,gen_n1000000_l74_merged.fq.gz,1000000,74,999914,1000000,-86,0.022,0:984124 1:15768 2:108
leeHom,gen_n1000000_l75_merged.fq.gz,1000000,75,999929,1000000,-71,0.021,0:984118 1:15754 2:128
leeHom,gen_n1000000_l76_merged.fq.gz,1000000,76,999914,999999,-85,0.021,0:983901 1:15976 2:120 3:2
leeHom,gen_n1000000_l77_merged.fq.gz,1000000,77,999902,1000000,-98,0.022,0:983534 1:16340 2:125 3:1
leeHom,gen_n1000000_l78_merged.fq.gz,1000000,78,999918,1000000,-82,0.022,0:983248 1:16615 2:136 3:1
leeHom,gen_n1000000_l79_merged.fq.gz,1000000,79,999921,1000000,-79,0.022,0:983147 1:16698 2:155
leeHom,gen_n1000000_l7_merged.fq.gz,1000000,7,999912,1000000,-88,0.032,0:997774 1:2223 2:3
leeHom,gen_n1000000_l80_merged.fq.gz,1000000,80,999907,1000000,-93,0.021,0:983076 1:16775 2:149
leeHom,gen_n1000000_l81_merged.fq.gz,1000000,81,999923,1000000,-77,0.021,0:982790 1:17064 2:146
leeHom,gen_n1000000_l82_merged.fq.gz,1000000,82,999924,1000000,-76,0.022,0:982193 1:17670 2:137
leeHom,gen_n1000000_l83_merged.fq.gz,1000000,83,999923,1000000,-77,0.021,0:982474 1:17371 2:155
leeHom,gen_n1000000_l84_merged.fq.gz,1000000,84,999906,1000000,-94,0.021,0:982157 1:17687 2:154 3:2
leeHom,gen_n1000000_l85_merged.fq.gz,1000000,85,999916,1000000,-84,0.022,0:981673 1:18166 2:159 3:2
leeHom,gen_n1000000_l86_merged.fq.gz,1000000,86,999921,1000000,-79,0.022,0:981375 1:18465 2:160
leeHom,gen_n1000000_l87_merged.fq.gz,1000000,87,999935,1000000,-65,0.022,0:981018 1:18795 2:185 3:2
leeHom,gen_n1000000_l88_merged.fq.gz,1000000,88,999924,1000000,-76,0.022,0:981197 1:18626 2:176 3:1
leeHom,gen_n1000000_l89_merged.fq.gz,1000000,89,999911,1000000,-89,0.021,0:981098 1:18708 2:192 3:2
leeHom,gen_n1000000_l8_merged.fq.gz,1000000,8,999921,1000000,-79,0.029,0:997674 1:2321 2:5
leeHom,gen_n1000000_l90_merged.fq.gz,1000000,90,999923,1000000,-77,0.021,0:980847 1:18966 2:187
leeHom,gen_n1000000_l91_merged.fq.gz,1000000,91,999915,1000000,-85,0.022,0:980458 1:19362 2:179 3:1
leeHom,gen_n1000000_l92_merged.fq.gz,1000000,92,999916,1000000,-84,0.022,0:980201 1:19597 2:200 3:2
leeHom,gen_n1000000_l93_merged.fq.gz,1000000,93,999908,1000000,-92,0.022,0:979828 1:19985 2:186 3:1
leeHom,gen_n1000000_l94_merged.fq.gz,1000000,94,999916,1000000,-84,0.022,0:979640 1:20157 2:201 3:2
leeHom,gen_n1000000_l95_merged.fq.gz,1000000,95,999918,1000000,-82,0.022,0:979378 1:20422 2:199 3:1
leeHom,gen_n1000000_l96_merged.fq.gz,1000000,96,999915,1000000,-85,0.022,0:979081 1:20664 2:252 3:3
leeHom,gen_n1000000_l97_merged.fq.gz,1000000,97,999915,1000000,-85,0.022,0:978909 1:20868 2:222 3:1
leeHom,gen_n1000000_l98_merged.fq.gz,1000000,98,999919,1000000,-81,0.022,0:978490 1:21260 2:249 3:1
leeHom,gen_n1000000_l99_merged.fq.gz,1000000,99,999915,1000000,-85,0.022,0:978316 1:21448 2:232 3:4
leeHom,gen_n1000000_l9_merged.fq.gz,1000000,9,999911,1000000,-89,0.026,0:997693 1:2305 2:2
