program,filename,nfrags,fraglen,total_sequences,total_reads,dropped_reads,avg_divergence_per_nt,edit_distances
SeqPrep,gen_n1000000_l1000_merged.fq.gz,1000000,1000,999921,1986,997935,79.815,760:336 761:87 762:99 763:126 764:225 765:32 766:13 767:16 768:73 769:23 770:22 771:6 772:9 773:5 774:12 775:10 776:2 777:3 778:6 779:7 780:6 781:1 782:7 783:3 784:2 785:2 787:1 788:4 789:3 790:1 791:1 792:7 793:4 794:4 795:2 796:6 798:4 800:6 801:3 802:3 803:3 804:8 806:1 807:2 808:7 809:3 810:4 811:1 812:3 813:12 814:2 816:4 817:1 818:4 819:5 822:1 823:4 824:1 825:1 826:2 827:1 828:4 829:1 830:13 831:3 832:5 833:8 834:3 835:1 836:8 837:2 838:5 839:2 840:4 841:1 843:5 844:1 847:2 848:9 849:43 850:525 851:20 853:12 854:5 855:2 856:1 857:2 858:5 859:1 860:1 861:1 863:5 864:1 868:6 870:2 873:5 874:2 877:2 878:4 880:1 881:1 882:2 883:4 884:1 885:3
SeqPrep,gen_n1000000_l100_merged.fq.gz,1000000,100,999928,1000000,-72,0.022,0:978016 1:21731 2:250 3:3
SeqPrep,gen_n1000000_l101_merged.fq.gz,1000000,101,999921,1000000,-79,0.022,0:977829 1:21912 2:255 3:4
SeqPrep,gen_n1000000_l102_merged.fq.gz,1000000,102,999926,1000000,-74,0.022,0:977395 1:22360 2:243 3:2
SeqPrep,gen_n1000000_l103_merged.fq.gz,1000000,103,999915,1000000,-85,0.022,0:977235 1:22516 2:244 3:4 4:1
SeqPrep,gen_n1000000_l104_merged.fq.gz,1000000,104,999911,999999,-88,0.022,0:977083 1:22631 2:279 3:6
SeqPrep,gen_n1000000_l105_merged.fq.gz,1000000,105,999920,999998,-78,0.022,0:976857 1:22881 2:257 3:3
SeqPrep,gen_n1000000_l106_merged.fq.gz,1000000,106,999938,1000000,-62,0.022,0:976435 1:23283 2:279 3:3
SeqPrep,gen_n1000000_l107_merged.fq.gz,1000000,107,999913,999995,-82,0.023,0:976097 1:23619 2:275 3:4
SeqPrep,gen_n1000000_l108_merged.fq.gz,1000000,108,999922,999975,-53,0.023,0:976127 1:23548 2:291 32:1 33:3 34:3 39:2
SeqPrep,gen_n1000000_l109_merged.fq.gz,1000000,109,999923,999922,1,0.023,0:975811 1:23804 2:275 3:4 26:2 32:4 33:13 34:2 35:3 36:2 39:2
SeqPrep,gen_n1000000_l10_merged.fq.gz,1000000,10,999901,1000000,-99,0.024,0:997607 1:2392 2:1
SeqPrep,gen_n1000000_l110_merged.fq.gz,1000000,110,999916,999634,282,0.025,0:974978 1:24277 2:294 3:7 16:1 18:1 26:3 28:1 29:1 30:1 31:1 32:5 33:43 34:5 35:5 36:3 37:3 38:1 39:4
SeqPrep,gen_n1000000_l111_merged.fq.gz,1000000,111,999908,997862,2046,0.028,0:972994 1:24374 2:306 3:1 15:3 18:1 22:1 25:1 26:1 27:1 28:6 29:3 30:3 31:1 32:7 33:91 34:18 35:20 36:7 37:9 38:3 39:11
SeqPrep,gen_n1000000_l112_merged.fq.gz,1000000,112,999924,996168,3756,0.04,0:970744 1:24516 2:306 3:4 15:4 18:3 22:1 23:1 25:2 26:14 28:19 29:5 30:15 31:11 32:36 33:280 34:51 35:50 36:31 37:19 38:13 39:31 40:12
SeqPrep,gen_n1000000_l113_merged.fq.gz,1000000,113,999914,994292,5622,0.05,0:968511 1:24538 2:300 3:2 15:17 18:1 20:1 22:4 23:2 24:3 25:2 26:18 27:3 28:29 29:8 30:22 31:23 32:45 33:436 34:82 35:72 36:33 37:27 38:30 39:63 40:20
SeqPrep,gen_n1000000_l114_merged.fq.gz,1000000,114,999932,995335,4597,0.051,0:969045 1:25022 2:307 3:2 15:12 22:3 23:1 25:2 26:10 27:2 28:32 29:10 30:16 31:23 32:31 33:486 34:76 35:69 36:28 37:37 38:39 39:56 40:26
SeqPrep,gen_n1000000_l115_merged.fq.gz,1000000,115,999935,995310,4625,0.051,0:968686 1:25325 2:322 3:3 4:1 15:10 20:2 21:1 22:1 24:3 25:3 26:15 27:2 28:36 29:15 30:31 31:19 32:49 33:414 34:83 35:82 36:31 37:32 38:32 39:42 40:31 41:39
SeqPrep,gen_n1000000_l116_merged.fq.gz,1000000,116,999926,988087,11839,0.052,0:962561 1:24304 2:196 15:8 16:1 20:2 22:3 23:3 24:4 25:3 26:14 27:3 28:29 29:9 30:24 31:15 32:41 33:470 34:79 35:82 36:21 37:34 38:46 39:66 40:23 41:46
SeqPrep,gen_n1000000_l117_merged.fq.gz,1000000,117,999917,988191,11726,0.051,0:962329 1:24624 2:245 15:1 16:1 18:1 20:1 21:1 22:2 23:2 24:3 25:2 26:16 27:3 28:24 29:6 30:27 31:17 32:48 33:455 34:80 35:83 36:27 37:27 38:27 39:73 40:32 41:34
SeqPrep,gen_n1000000_l118_merged.fq.gz,1000000,118,999936,987602,12334,0.052,0:961662 1:24653 2:236 19:1 20:2 22:6 23:1 24:2 25:1 26:21 27:2 28:28 29:10 30:23 31:25 32:38 33:466 34:64 35:87 36:34 37:31 38:30 39:78 40:26 41:38 42:37
SeqPrep,gen_n1000000_l119_merged.fq.gz,1000000,119,999928,987063,12865,0.051,0:960867 1:24949 2:233 15:1 20:2 22:4 23:6 24:6 25:3 26:16 27:3 28:31 29:15 30:24 31:14 32:41 33:473 34:58 35:43 36:41 37:30 38:40 39:56 40:29 41:32 42:45 111:1
SeqPrep,gen_n1000000_l11_merged.fq.gz,1000000,11,999928,1000000,-72,0.023,0:997517 1:2482 2:1
SeqPrep,gen_n1000000_l120_merged.fq.gz,1000000,120,999913,986903,13010,0.051,0:960359 1:25274 2:253 20:2 22:3 23:2 25:5 26:13 27:6 28:37 29:14 30:20 31:16 32:47 33:484 34:59 35:27 36:32 37:38 38:37 39:72 40:41 41:25 42:37
SeqPrep,gen_n1000000_l121_merged.fq.gz,1000000,121,999915,986689,13226,0.042,0:960536 1:25249 2:220 23:1 24:4 25:2 26:16 27:4 28:33 29:13 30:9 31:13 32:38 33:183 34:52 35:41 36:37 37:35 38:34 39:52 40:30 41:24 42:33 43:30
SeqPrep,gen_n1000000_l122_merged.fq.gz,1000000,122,999926,986332,13594,0.038,0:959795 1:25756 2:240 8:1 20:1 21:1 22:1 23:1 25:1 26:15 27:5 28:25 29:7 30:12 31:12 32:50 33:75 34:34 35:28 36:32 37:39 38:36 39:37 40:38 41:29 42:26 43:35
SeqPrep,gen_n1000000_l123_merged.fq.gz,1000000,123,999926,986002,13924,0.036,0:959331 1:25917 2:261 8:2 20:1 21:1 22:2 23:3 24:1 25:2 26:5 28:38 29:9 30:17 31:25 32:35 33:30 34:27 35:27 36:36 37:29 38:37 39:32 40:33 41:37 42:33 43:31
SeqPrep,gen_n1000000_l124_merged.fq.gz,1000000,124,999907,985701,14206,0.036,0:958640 1:26311 2:280 4:1 6:1 7:1 23:4 24:4 25:1 26:2 27:3 28:14 29:9 30:8 31:10 32:41 33:33 34:29 35:35 36:19 37:32 38:37 39:29 40:44 41:38 42:33 43:20 44:21 115:1
SeqPrep,gen_n1000000_l125_merged.fq.gz,1000000,125,999938,982744,17194,0.036,0:955630 1:26383 2:264 10:1 11:1 21:2 23:1 25:2 26:1 27:6 28:5 29:9 30:9 31:17 32:18 33:27 34:31 35:45 36:31 37:36 38:39 39:29 40:33 41:34 42:27 43:24 44:31 88:1 105:1 107:1 113:1 115:2 116:2
SeqPrep,gen_n1000000_l126_merged.fq.gz,1000000,126,999918,982873,17045,0.032,0:953599 1:28665 2:348 3:1 4:1 12:2 25:1 26:1 27:2 28:6 29:3 30:6 31:7 32:16 33:16 34:31 35:24 36:21 37:20 38:25 39:24 40:17 41:31 64:1 97:1 108:1 110:1 114:2
SeqPrep,gen_n1000000_l127_merged.fq.gz,1000000,127,999911,983473,16438,0.032,0:951937 1:30934 2:397 3:1 20:1 27:1 28:1 29:1 30:1 31:2 32:2 33:8 34:13 35:18 36:30 37:27 38:19 39:23 40:26 41:26 62:1 71:1 78:1 110:2
SeqPrep,gen_n1000000_l128_merged.fq.gz,1000000,128,999924,982967,16957,0.032,0:949421 1:32876 2:500 3:1 4:1 9:1 10:1 12:1 13:1 25:1 27:1 29:1 30:2 31:3 32:1 33:3 34:3 35:11 36:13 37:21 38:24 39:24 40:28 41:18 64:1 67:1 71:1 92:1 94:1 104:1 110:1 111:3
SeqPrep,gen_n1000000_l129_merged.fq.gz,1000000,129,999908,983204,16704,0.034,0:946573 1:35946 2:541 3:7 5:1 24:1 31:2 32:2 33:1 34:1 35:1 36:7 37:8 38:20 39:14 40:24 41:28 42:21 60:1 70:1 105:1 110:2 111:1
SeqPrep,gen_n1000000_l12_merged.fq.gz,1000000,12,999912,1000000,-88,0.022,0:997368 1:2627 2:5
SeqPrep,gen_n1000000_l130_merged.fq.gz,1000000,130,999922,983010,16912,0.035,0:943539 1:38707 2:672 3:8 6:1 8:1 13:1 20:2 27:1 35:3 36:4 37:4 38:4 39:5 40:7 41:16 42:22 96:1 106:1 108:1 110:7 111:3
SeqPrep,gen_n1000000_l131_merged.fq.gz,1000000,131,999914,983796,16118,0.035,0:941390 1:41520 2:841 3:8 12:1 16:1 35:1 36:2 37:1 38:1 39:2 40:3 41:5 42:14 98:1 99:1 105:2 108:1 109:1
SeqPrep,gen_n1000000_l132_merged.fq.gz,1000000,132,999903,983642,16261,0.036,0:938592 1:44103 2:920 3:7 16:1 17:1 34:1 39:1 40:2 41:3 42:4 101:1 104:3 106:2 108:1
SeqPrep,gen_n1000000_l133_merged.fq.gz,1000000,133,999924,983742,16182,0.038,0:936396 1:46180 2:1131 3:9 12:1 14:1 16:1 17:2 26:2 38:1 39:1 43:3 66:1 96:1 99:1 103:1 104:2 105:7 106:1
SeqPrep,gen_n1000000_l134_merged.fq.gz,1000000,134,999910,983535,16375,0.039,0:933904 1:48482 2:1121 3:9 12:1 13:1 17:2 18:1 20:2 36:1 43:2 90:1 94:1 100:3 105:4
SeqPrep,gen_n1000000_l135_merged.fq.gz,1000000,135,999914,983751,16163,0.041,0:932083 1:50341 2:1273 3:29 12:1 16:1 17:1 18:1 20:2 21:1 31:1 39:1 42:3 63:1 98:1 100:2 103:1 104:2 105:6
SeqPrep,gen_n1000000_l136_merged.fq.gz,1000000,136,999919,984378,15541,0.042,0:929862 1:53038 2:1439 3:20 12:2 15:1 18:3 20:1 21:1 22:1 32:1 39:1 57:1 58:1 63:1 100:2 104:3
SeqPrep,gen_n1000000_l137_merged.fq.gz,1000000,137,999921,984440,15481,0.043,0:928187 1:54665 2:1548 3:22 13:1 16:1 18:2 20:1 21:2 22:2 23:1 41:1 42:1 43:1 58:1 96:1 100:1 101:1 102:1
SeqPrep,gen_n1000000_l138_merged.fq.gz,1000000,138,999916,984375,15541,0.046,0:925513 1:57090 2:1711 3:33 15:1 16:1 19:2 20:2 21:1 22:1 24:8 25:1 91:2 93:1 97:1 99:2 100:1 101:4
SeqPrep,gen_n1000000_l139_merged.fq.gz,1000000,139,999922,984288,15634,0.047,0:922936 1:59479 2:1813 3:26 4:1 17:1 18:2 20:1 21:3 23:2 24:8 25:6 95:1 98:2 100:4 101:3
SeqPrep,gen_n1000000_l13_merged.fq.gz,1000000,13,999925,1000000,-75,0.022,0:997156 1:2842 2:2
SeqPrep,gen_n1000000_l140_merged.fq.gz,1000000,140,999928,984266,15662,0.049,0:920829 1:61448 2:1913 3:40 18:1 19:1 20:1 22:1 23:2 24:3 25:7 26:8 95:1 96:2 97:1 98:1 100:3 101:4
SeqPrep,gen_n1000000_l141_merged.fq.gz,1000000,141,999935,984913,15022,0.049,0:919583 1:63110 2:2134 3:49 4:1 18:1 19:1 22:1 23:4 24:6 25:6 26:8 27:5 92:1 95:1 99:2
SeqPrep,gen_n1000000_l142_merged.fq.gz,1000000,142,999939,984924,15015,0.052,0:916743 1:65786 2:2284 3:52 4:1 20:1 21:1 22:2 23:1 24:9 25:6 26:15 27:2 28:11 78:1 85:1 88:1 95:4 96:1 98:2
SeqPrep,gen_n1000000_l143_merged.fq.gz,1000000,143,999923,985034,14889,0.053,0:914915 1:67641 2:2350 3:53 4:1 20:2 21:3 22:1 24:6 25:2 26:8 27:14 28:14 29:18 93:1 94:1 95:2 96:1 97:1
SeqPrep,gen_n1000000_l144_merged.fq.gz,1000000,144,999931,984897,15034,0.055,0:912319 1:69841 2:2576 3:66 4:2 21:1 22:1 23:2 24:7 25:3 26:8 27:11 28:20 29:16 30:14 84:1 88:1 95:4 96:4
SeqPrep,gen_n1000000_l145_merged.fq.gz,1000000,145,999928,984642,15286,0.057,0:909352 1:72316 2:2815 3:48 22:2 23:4 24:6 25:3 26:12 27:13 28:21 29:16 30:15 31:13 84:1 87:1 92:1 95:2 96:1
SeqPrep,gen_n1000000_l146_merged.fq.gz,1000000,146,999929,985727,14202,0.058,0:908498 1:73983 2:3073 3:72 4:3 22:2 23:3 24:5 25:3 26:8 27:10 28:13 29:14 30:11 31:8 32:14 33:1 81:1 84:1 90:3 91:1
SeqPrep,gen_n1000000_l147_merged.fq.gz,1000000,147,999921,985809,14112,0.06,0:905745 1:76733 2:3119 3:78 4:1 23:5 24:10 25:3 26:8 27:10 28:13 29:27 30:15 31:12 32:16 33:10 34:1 75:1 90:2
SeqPrep,gen_n1000000_l148_merged.fq.gz,1000000,148,999912,985913,13999,0.062,0:903648 1:78755 2:3264 3:109 24:7 25:6 26:11 27:11 28:18 29:13 30:17 31:16 32:17 33:5 34:11 72:1 84:1 85:1 90:2
SeqPrep,gen_n1000000_l149_merged.fq.gz,1000000,149,999919,985638,14281,0.063,0:901650 1:80249 2:3481 3:101 25:5 26:6 27:4 28:19 29:16 30:19 31:9 32:17 33:21 34:19 35:11 84:2 85:1 86:1 90:5 91:2
SeqPrep,gen_n1000000_l14_merged.fq.gz,1000000,14,999918,1000000,-82,0.022,0:996868 1:3128 2:4
SeqPrep,gen_n1000000_l150_merged.fq.gz,1000000,150,999914,985279,14635,0.065,0:898676 1:82703 2:3619 3:121 26:6 27:7 28:13 29:19 30:20 31:19 32:17 33:15 34:21 35:10 36:8 66:1 80:1 85:1 90:1 91:1
SeqPrep,gen_n1000000_l151_merged.fq.gz,1000000,151,999923,940284,59639,0.064,0:859860 1:76878 2:3296 3:86 4:2 5:1 26:1 27:5 28:15 29:14 30:15 31:10 32:9 33:10 34:13 35:12 36:2 37:6 51:1 55:1 59:1 64:2 67:1 70:1 75:1 76:1 79:1 81:2 83:1 84:10 85:12 86:3 87:1 88:8 89:2
SeqPrep,gen_n1000000_l152_merged.fq.gz,1000000,152,999920,940621,59299,0.066,0:858129 1:78783 2:3420 3:92 4:1 27:1 28:15 29:18 30:15 31:16 32:19 33:14 34:16 35:11 36:9 37:10 38:6 39:1 62:1 63:1 65:1 67:1 75:2 76:2 78:1 80:1 82:2 83:2 84:10 85:12 86:3 87:1 88:5
SeqPrep,gen_n1000000_l153_merged.fq.gz,1000000,153,999914,941401,58513,0.069,0:855854 1:81524 2:3693 3:116 4:1 29:10 30:13 31:20 32:12 33:17 34:14 35:11 36:8 37:12 38:22 39:11 40:2 41:1 42:1 61:1 64:3 67:1 72:3 77:1 79:2 80:1 82:2 84:10 85:29 86:4 87:2
SeqPrep,gen_n1000000_l154_merged.fq.gz,1000000,154,999923,941365,58558,0.071,0:854068 1:83138 2:3824 3:109 4:2 25:1 30:20 31:14 32:7 33:13 34:26 35:9 36:9 37:9 38:15 39:9 40:10 41:1 65:1 72:1 74:1 77:2 78:1 79:4 80:4 81:1 82:1 83:3 84:16 85:39 86:7
SeqPrep,gen_n1000000_l155_merged.fq.gz,1000000,155,999916,942041,57875,0.072,0:851944 1:85681 2:4072 3:126 4:1 26:1 30:1 31:11 32:17 33:17 34:23 35:12 36:16 37:8 38:12 39:13 40:5 41:7 62:1 76:1 77:2 78:1 80:3 81:2 82:6 83:1 84:26 85:31
SeqPrep,gen_n1000000_l156_merged.fq.gz,1000000,156,999920,943138,56782,0.072,0:851437 1:87114 2:4257 3:134 4:1 30:2 32:16 33:17 34:15 35:13 36:10 37:7 38:14 39:8 40:7 41:7 42:7 43:1 58:1 63:1 64:1 66:1 68:1 70:1 71:2 74:2 75:2 76:1 77:1 78:2 80:17 81:5 83:7 84:23 85:3
SeqPrep,gen_n1000000_l157_merged.fq.gz,1000000,157,999892,944287,55605,0.072,0:850283 1:89172 2:4515 3:158 4:4 22:1 33:11 34:13 35:14 36:14 37:5 38:13 39:8 40:4 41:5 42:12 43:3 51:1 53:1 60:1 66:1 73:1 74:1 75:1 76:3 78:3 79:2 80:26 81:3 82:2 83:4 84:2
SeqPrep,gen_n1000000_l158_merged.fq.gz,1000000,158,999933,944726,55207,0.073,0:848300 1:91436 2:4695 3:146 4:5 33:1 34:17 35:8 36:8 37:7 38:8 39:6 40:7 41:4 42:8 43:3 44:6 55:1 62:2 64:2 66:1 72:2 73:1 74:1 75:2 76:1 77:1 78:1 79:3 80:27 81:7 82:9
SeqPrep,gen_n1000000_l159_merged.fq.gz,1000000,159,999910,945100,54810,0.074,0:846860 1:93059 2:4881 3:165 4:1 28:1 29:1 31:2 35:10 36:10 37:6 38:13 39:11 40:6 41:1 42:6 43:4 44:6 45:5 53:1 58:1 60:1 61:1 62:1 66:1 70:2 71:1 73:1 74:2 75:3 78:3 79:6 80:20 81:8
SeqPrep,gen_n1000000_l15_merged.fq.gz,1000000,15,999906,1000000,-94,0.022,0:996721 1:3274 2:5
SeqPrep,gen_n1000000_l160_merged.fq.gz,1000000,160,999911,945590,54321,0.076,0:844849 1:95153 2:5262 3:181 4:3 29:1 30:2 34:1 36:14 37:7 38:8 39:7 40:7 41:8 42:6 43:2 44:4 45:2 46:3 59:1 61:2 64:2 65:1 66:1 68:1 69:1 70:2 72:3 73:1 75:6 76:1 77:2 78:1 79:8 80:34 81:3
SeqPrep,gen_n1000000_l161_merged.fq.gz,1000000,161,999908,946982,52926,0.076,0:843749 1:97499 2:5409 3:209 4:2 37:3 38:7 39:7 40:8 41:9 42:4 43:5 44:9 45:6 46:5 47:4 56:1 64:1 65:2 66:1 67:1 68:1 69:1 71:1 72:3 73:1 75:13 76:3 78:7 79:11
SeqPrep,gen_n1000000_l162_merged.fq.gz,1000000,162,999910,947783,52127,0.078,0:842326 1:99276 2:5824 3:210 4:5 5:1 20:1 29:3 31:1 32:1 35:1 38:11 39:10 40:10 41:3 42:11 43:5 44:7 45:5 46:8 47:4 48:6 49:1 54:1 62:1 63:1 65:1 66:1 68:2 69:2 70:1 71:2 72:1 73:1 74:1 75:13 76:8 77:5 78:10 79:2
SeqPrep,gen_n1000000_l163_merged.fq.gz,1000000,163,999933,947974,51959,0.078,0:840354 1:101269 2:5984 3:230 4:9 27:1 28:1 31:1 35:1 39:6 40:2 41:5 42:6 43:4 44:9 45:4 46:4 47:4 48:14 49:9 50:2 52:1 54:1 55:1 56:1 61:2 62:1 63:1 64:2 67:1 70:1 71:1 72:2 75:26 76:10 77:4
SeqPrep,gen_n1000000_l164_merged.fq.gz,1000000,164,999915,948058,51857,0.079,0:838554 1:102922 2:6227 3:236 4:4 34:1 40:2 41:2 42:9 43:4 44:3 45:5 46:5 47:9 48:6 49:7 50:6 52:1 62:1 64:1 65:2 67:1 68:3 69:2 70:3 72:7 74:3 75:25 76:6 77:1
SeqPrep,gen_n1000000_l165_merged.fq.gz,1000000,165,999917,948861,51056,0.081,0:836880 1:105230 2:6369 3:239 4:8 29:1 33:1 38:1 39:1 41:4 42:7 43:5 44:7 45:3 46:5 47:6 48:8 49:5 50:11 51:10 52:1 53:2 54:1 61:1 63:1 64:1 65:1 68:2 69:5 71:1 72:3 73:2 74:2 75:36 76:1
SeqPrep,gen_n1000000_l166_merged.fq.gz,1000000,166,999915,950293,49622,0.081,0:835643 1:107473 2:6760 3:301 4:8 28:1 32:1 42:3 43:3 44:5 45:7 46:2 47:7 48:8 49:8 50:4 51:4 52:12 56:1 57:1 64:4 65:1 67:1 68:2 69:1 70:12 71:5 72:8 73:2 74:4 75:1
SeqPrep,gen_n1000000_l167_merged.fq.gz,1000000,167,999913,950952,48961,0.082,0:833692 1:109834 2:7012 3:286 4:12 25:1 32:1 42:1 43:2 44:12 45:2 46:3 47:4 48:12 49:8 50:9 51:6 52:15 53:10 58:1 63:1 64:3 65:1 68:2 70:8 71:4 72:9 73:1
SeqPrep,gen_n1000000_l168_merged.fq.gz,1000000,168,999917,951143,48774,0.084,0:831854 1:111324 2:7505 3:334 4:8 29:1 43:1 44:5 45:3 46:6 47:6 48:6 49:3 50:7 51:8 52:12 53:8 54:6 60:1 61:1 62:3 63:1 65:2 66:3 67:2 68:1 69:1 70:17 71:3 72:10 73:1
SeqPrep,gen_n1000000_l169_merged.fq.gz,1000000,169,999922,951702,48220,0.085,0:830495 1:113254 2:7496 3:323 4:10 23:1 39:1 40:1 43:1 45:5 46:4 47:5 48:11 49:6 50:3 51:5 52:4 53:14 54:13 55:6 58:1 60:2 63:1 64:1 65:1 66:1 68:4 69:4 70:23 71:6
SeqPrep,gen_n1000000_l16_merged.fq.gz,1000000,16,999917,1000000,-83,0.022,0:996501 1:3498 2:1
SeqPrep,gen_n1000000_l170_merged.fq.gz,1000000,170,999923,952030,47893,0.087,0:828040 1:115533 2:7916 3:376 4:9 25:1 38:1 40:1 46:13 47:6 48:8 49:7 50:8 51:4 52:10 53:9 54:13 55:5 56:22 59:1 60:1 61:1 64:3 65:2 66:2 68:4 69:5 70:23 71:6
SeqPrep,gen_n1000000_l171_merged.fq.gz,1000000,171,999914,953478,46436,0.087,0:827125 1:117596 2:8238 3:375 4:12 5:1 30:1 36:1 39:1 46:1 47:6 48:5 49:9 50:8 51:9 52:10 53:6 54:12 55:4 56:15 57:5 58:1 60:2 63:1 65:12 66:6 67:2 68:5 69:9
SeqPrep,gen_n1000000_l172_merged.fq.gz,1000000,172,999922,953886,46036,0.088,0:824790 1:120008 2:8529 3:417 4:20 5:1 24:1 29:1 31:1 32:2 38:1 45:1 47:1 48:6 49:6 50:6 51:5 52:6 53:6 54:17 55:3 56:13 57:3 58:12 60:2 61:1 62:2 63:1 64:4 65:10 66:3 67:3 68:3 69:1
SeqPrep,gen_n1000000_l173_merged.fq.gz,1000000,173,999927,954531,45396,0.09,0:823336 1:121746 2:8899 3:414 4:9 5:1 36:1 46:1 49:6 50:6 51:7 52:10 53:10 54:10 55:1 56:14 57:9 58:21 59:3 60:1 62:1 64:5 65:12 66:6 67:2
SeqPrep,gen_n1000000_l174_merged.fq.gz,1000000,174,999914,955695,44219,0.091,0:822474 1:123573 2:9053 3:441 4:13 5:1 35:1 36:1 39:1 44:1 45:1 50:8 51:9 52:12 53:5 54:12 55:3 56:16 57:2 58:14 59:8 60:11 61:2 62:1 63:3 64:3 65:19 66:5 67:2
SeqPrep,gen_n1000000_l175_merged.fq.gz,1000000,175,999925,955400,44525,0.092,0:820240 1:124954 2:9532 3:506 4:21 24:1 34:1 42:1 43:1 47:1 49:1 50:1 51:5 52:9 53:4 54:10 55:4 56:17 57:4 58:11 59:7 60:22 61:7 62:1 63:2 64:7 65:26 66:4
SeqPrep,gen_n1000000_l176_merged.fq.gz,1000000,176,999930,956676,43254,0.093,0:818509 1:127792 2:9743 3:467 4:16 5:1 29:1 32:1 35:1 40:1 45:1 48:1 49:1 50:1 52:11 53:4 54:17 55:7 56:17 57:4 58:20 59:2 60:25 61:6 62:17 63:3 64:6 65:1
SeqPrep,gen_n1000000_l177_merged.fq.gz,1000000,177,999920,957374,42546,0.095,0:816776 1:129740 2:10200 3:485 4:22 5:1 33:1 34:1 38:2 44:1 45:1 50:1 51:1 53:7 54:16 55:3 56:12 57:6 58:20 59:3 60:31 61:9 62:26 63:8 64:1
SeqPrep,gen_n1000000_l178_merged.fq.gz,1000000,178,999916,957725,42191,0.096,0:814817 1:131868 2:10316 3:541 4:19 36:1 38:1 44:1 46:1 47:1 50:2 52:4 54:17 55:5 56:10 57:5 58:14 59:8 60:37 61:5 62:20 63:7 64:24 65:1
SeqPrep,gen_n1000000_l179_merged.fq.gz,1000000,179,999920,958237,41683,0.098,0:812967 1:133583 2:10890 3:586 4:30 31:1 33:1 39:1 41:2 50:3 51:1 53:1 54:1 55:4 56:14 57:3 58:18 59:5 60:40 61:8 62:14 63:6 64:51 65:7
SeqPrep,gen_n1000000_l17_merged.fq.gz,1000000,17,999905,1000000,-95,0.022,0:996242 1:3750 2:8
SeqPrep,gen_n1000000_l180_merged.fq.gz,1000000,180,999915,958559,41356,0.098,0:811264 1:135447 2:11067 3:582 4:32 33:1 38:1 42:1 46:1 51:1 52:1 53:1 54:2 55:2 56:13 57:8 58:14 59:6 60:33 61:11 62:15 63:4 64:29 65:1 66:22
SeqPrep,gen_n1000000_l181_merged.fq.gz,1000000,181,999924,959644,40280,0.1,0:809376 1:137904 2:11569 3:595 4:38 40:2 50:3 52:2 53:2 54:2 55:11 56:4 57:2 58:14 59:9 60:20 61:5 62:12 63:7 64:34 65:4 66:19 67:10
SeqPrep,gen_n1000000_l182_merged.fq.gz,1000000,182,999910,960287,39623,0.1,0:807872 1:139837 2:11708 3:684 4:21 5:1 42:1 45:1 46:1 47:1 48:1 50:1 51:1 53:1 54:1 55:12 56:4 57:2 58:15 59:6 60:14 61:4 62:13 63:5 64:39 65:1 66:13 67:4 68:22 87:1
SeqPrep,gen_n1000000_l183_merged.fq.gz,1000000,183,999924,960771,39153,0.102,0:806181 1:141361 2:12295 3:729 4:32 5:1 43:1 45:2 48:2 50:1 51:1 54:3 55:17 56:6 57:3 58:1 59:5 60:9 61:7 62:16 63:8 64:52 65:3 66:17 67:2 68:15 69:1
SeqPrep,gen_n1000000_l184_merged.fq.gz,1000000,184,999926,960915,39011,0.103,0:803877 1:143501 2:12633 3:713 4:16 31:1 32:1 38:1 40:2 41:1 46:1 47:1 48:2 49:1 50:1 51:2 52:1 53:2 54:2 55:14 56:5 58:1 60:16 61:6 62:18 63:6 64:46 65:4 66:11 67:5 68:9 69:6 70:8 71:1
SeqPrep,gen_n1000000_l185_merged.fq.gz,1000000,185,999927,961573,38354,0.103,0:801810 1:145597 2:13177 3:801 4:37 42:1 45:1 49:1 51:1 52:2 53:1 54:3 55:13 56:5 61:2 62:16 63:8 64:41 65:4 66:16 67:4 68:13 69:1 70:16 71:2
SeqPrep,gen_n1000000_l186_merged.fq.gz,1000000,186,999915,962983,36932,0.105,0:800451 1:147779 2:13663 3:893 4:32 5:2 42:1 44:1 45:2 46:1 49:1 50:9 51:4 53:3 54:4 55:1 62:22 63:8 64:41 65:3 66:14 67:4 68:13 69:3 70:14 71:3 72:11
SeqPrep,gen_n1000000_l187_merged.fq.gz,1000000,187,999925,963326,36599,0.104,0:798657 1:149696 2:14014 3:802 4:27 5:1 8:1 12:1 32:1 33:1 34:1 37:2 42:2 43:1 46:2 48:3 49:1 50:9 51:1 52:2 53:4 58:1 63:7 64:28 65:2 66:6 67:8 68:21 69:1 70:14 72:6 73:3
SeqPrep,gen_n1000000_l188_merged.fq.gz,1000000,188,999917,963617,36300,0.106,0:796605 1:151696 2:14242 3:900 4:35 6:1 30:1 38:1 42:2 45:1 48:1 49:2 50:12 51:5 52:6 56:1 60:1 64:37 65:1 66:8 67:7 68:17 69:2 70:11 72:13 73:2 74:7
SeqPrep,gen_n1000000_l189_merged.fq.gz,1000000,189,999930,963677,36253,0.106,0:794918 1:153307 2:14351 3:913 4:51 5:1 33:1 42:2 44:1 45:3 46:1 48:4 49:7 50:18 51:7 52:1 56:1 58:1 60:1 65:2 66:22 67:9 68:13 69:4 70:8 71:4 72:10 73:4 74:10 75:2
SeqPrep,gen_n1000000_l18_merged.fq.gz,1000000,18,999914,1000000,-86,0.021,0:996153 1:3842 2:5
SeqPrep,gen_n1000000_l190_merged.fq.gz,1000000,190,999924,963824,36100,0.108,0:791962 1:155535 2:15128 3:1023 4:42 5:3 34:1 36:1 39:1 41:2 42:3 44:2 46:3 49:9 50:20 51:3 52:1 55:1 56:1 64:1 66:13 67:4 68:13 69:2 70:12 71:1 72:11 73:1 74:7 75:6 76:11 77:1
SeqPrep,gen_n1000000_l191_merged.fq.gz,1000000,191,999921,965576,34345,0.108,0:790956 1:157635 2:15820 3:1000 4:60 5:1 31:1 32:1 42:4 43:1 44:1 45:4 46:3 47:1 48:6 49:5 50:3 56:1 57:1 64:1 67:4 68:9 69:6 70:6 72:10 73:3 74:13 75:7 76:11 77:2
SeqPrep,gen_n1000000_l192_merged.fq.gz,1000000,192,999907,966281,33626,0.109,0:788202 1:160655 2:16190 3:1073 4:58 5:3 27:1 36:1 42:2 45:10 46:7 47:2 48:2 62:1 68:11 69:1 70:4 71:2 72:12 73:5 74:10 75:4 76:8 77:3 78:14
SeqPrep,gen_n1000000_l193_merged.fq.gz,1000000,193,999920,966772,33148,0.109,0:787286 1:161893 2:16334 3:1115 4:57 5:2 38:1 41:1 42:3 43:2 45:9 46:8 47:4 59:1 63:1 69:1 70:8 72:12 73:1 74:9 75:3 76:4 77:1 78:15 79:1
SeqPrep,gen_n1000000_l194_merged.fq.gz,1000000,194,999925,966826,33099,0.11,0:785569 1:163053 2:16863 3:1183 4:61 5:1 30:1 38:1 40:1 42:2 43:1 44:2 45:14 46:6 70:12 71:1 72:12 73:2 74:8 75:2 76:10 77:2 78:7 79:3 80:8 81:1
SeqPrep,gen_n1000000_l195_merged.fq.gz,1000000,195,999921,967187,32734,0.112,0:782463 1:165911 2:17440 3:1213 4:62 5:3 25:1 26:1 30:1 31:1 34:1 38:1 40:3 42:6 43:2 44:2 45:8 46:4 47:1 49:1 68:1 71:1 72:17 74:6 75:2 76:6 77:6 78:14 79:2 80:2 81:5
SeqPrep,gen_n1000000_l196_merged.fq.gz,1000000,196,999940,968584,31356,0.113,0:780611 1:168645 2:17944 3:1214 4:74 5:6 28:1 36:1 37:1 39:1 40:4 42:5 43:1 44:2 70:1 72:15 73:3 74:11 75:5 76:10 77:4 78:10 79:2 80:3 81:8 82:2
SeqPrep,gen_n1000000_l197_merged.fq.gz,1000000,197,999919,968894,31025,0.114,0:778029 1:170695 2:18740 3:1276 4:75 5:4 28:1 33:1 35:1 36:1 37:1 39:1 40:6 41:2 42:2 43:3 73:1 74:7 75:4 76:13 77:6 78:10 80:7 81:2 82:5 83:1
SeqPrep,gen_n1000000_l198_merged.fq.gz,1000000,198,999913,969045,30868,0.116,0:776016 1:172444 2:19029 3:1341 4:88 5:5 6:1 24:1 34:2 35:1 36:1 37:1 38:1 39:1 40:9 41:5 42:5 43:3 44:1 55:1 58:1 59:1 60:1 64:1 74:17 75:4 76:14 77:1 78:20 79:1 80:6 81:6 82:5 84:11
SeqPrep,gen_n1000000_l199_merged.fq.gz,1000000,199,999921,970143,29778,0.116,0:773889 1:174956 2:19663 3:1458 4:94 5:3 30:1 32:1 35:3 36:2 37:1 38:2 39:2 40:7 41:4 42:3 71:1 75:1 76:10 77:2 78:6 79:1 80:2 81:7 82:3 84:18 85:3
SeqPrep,gen_n1000000_l19_merged.fq.gz,1000000,19,999898,1000000,-102,0.021,0:995959 1:4034 2:7
SeqPrep,gen_n1000000_l1_merged.fq.gz,1000000,1,999924,1000000,-76,0.045,0:999550 1:450
SeqPrep,gen_n1000000_l200_merged.fq.gz,1000000,200,999912,970296,29616,0.118,0:771842 1:176542 2:20172 3:1527 4:96 5:4 26:1 28:2 32:1 34:1 35:2 36:2 37:1 38:2 39:2 40:14 41:3 42:1 53:1 64:2 72:1 76:10 77:3 78:13 79:1 80:10 81:3 82:5 84:25 85:4 86:3
SeqPrep,gen_n1000000_l201_merged.fq.gz,1000000,201,999934,796659,203275,0.12,0:638315 1:141340 2:15473 3:1149 4:65 5:5 19:1 20:1 21:2 22:2 23:3 24:5 25:4 26:2 27:2 28:3 29:5 30:10 31:4 32:6 33:3 34:6 35:58 36:32 37:12 38:11 39:24 40:6 44:1 47:1 49:2 51:1 52:2 53:3 54:1 55:2 59:1 60:1 61:2 62:2 63:1 64:3 67:1 72:1 77:3 78:9 79:1 80:7 81:6 82:9 84:24 85:3 86:5 87:18
SeqPrep,gen_n1000000_l202_merged.fq.gz,1000000,202,999919,798435,201484,0.12,0:637135 1:143837 2:15973 3:1129 4:69 5:2 16:1 21:2 22:1 23:1 24:2 25:1 26:6 27:1 28:4 29:2 30:8 31:4 32:6 33:8 34:6 35:66 36:39 37:20 38:22 39:2 47:1 48:1 49:1 51:1 53:1 55:1 57:2 59:1 61:2 62:1 63:1 64:2 67:1 68:1 78:13 79:1 80:5 81:11 82:4 84:14 85:2 86:2 87:11 88:7 89:1
SeqPrep,gen_n1000000_l203_merged.fq.gz,1000000,203,999910,801185,198725,0.121,0:636774 1:146179 2:16607 3:1248 4:84 5:4 6:1 12:1 19:1 21:1 22:2 25:1 26:3 27:2 28:4 29:4 30:4 31:5 32:6 33:5 34:8 35:79 36:41 37:27 38:1 39:2 40:1 42:1 45:1 48:1 52:1 53:1 54:1 55:1 56:1 58:1 59:1 60:1 62:3 64:5 67:1 69:1 76:2 79:1 80:5 81:6 82:8 83:1 84:18 85:3 86:3 87:11 88:11
SeqPrep,gen_n1000000_l204_merged.fq.gz,1000000,204,999907,803963,195944,0.124,0:636869 1:148193 2:17095 3:1367 4:74 5:4 20:2 21:1 22:1 23:4 24:3 25:8 26:5 27:7 28:3 29:5 30:15 31:8 32:9 33:10 34:15 35:96 36:49 37:13 42:1 47:1 48:1 49:1 51:1 52:1 56:1 57:1 58:2 59:1 62:2 64:8 67:2 68:1 76:1 77:1 80:6 81:2 82:11 84:10 85:6 86:9 87:11 88:7 89:1 90:18
SeqPrep,gen_n1000000_l205_merged.fq.gz,1000000,205,999929,807504,192425,0.126,0:637023 1:150984 2:17666 3:1340 4:95 5:2 6:2 10:1 14:1 19:1 20:1 21:1 22:3 23:3 24:6 25:2 26:9 27:2 28:10 29:5 30:26 31:8 32:17 33:12 34:14 35:141 36:28 37:3 40:1 45:1 46:2 47:1 48:1 50:1 51:1 55:1 62:2 63:1 64:2 66:1 67:1 68:1 71:1 81:5 82:7 84:19 85:3 86:10 87:13 88:13 89:3 90:7
SeqPrep,gen_n1000000_l206_merged.fq.gz,1000000,206,999928,810620,189308,0.123,0:637627 1:152679 2:18520 3:1457 4:97 5:4 15:1 18:1 20:1 23:1 24:2 25:7 26:6 27:2 28:10 29:3 30:46 31:12 32:14 33:9 34:25 35:7 39:1 44:1 49:1 52:3 57:1 58:1 62:1 63:1 64:2 66:2 67:1 74:1 75:2 76:1 80:1 82:4 83:2 84:21 85:4 86:2 87:9 88:3 89:3 90:14 91:4 92:3
SeqPrep,gen_n1000000_l207_merged.fq.gz,1000000,207,999924,812361,187563,0.126,0:636831 1:154815 2:18831 3:1506 4:85 5:5 18:1 20:3 21:3 22:1 23:1 24:4 25:2 26:8 27:3 28:9 29:10 30:64 31:13 32:27 33:26 34:5 35:1 36:1 37:1 39:1 40:1 42:1 47:1 48:1 50:1 51:1 52:1 53:1 54:1 60:1 63:2 64:6 67:1 69:1 72:1 74:1 76:1 77:1 78:1 79:1 83:1 84:19 85:4 86:1 87:14 88:2 90:17 91:1 92:8 93:11
SeqPrep,gen_n1000000_l208_merged.fq.gz,1000000,208,999926,815362,184564,0.127,0:636131 1:157864 2:19359 3:1657 4:75 5:6 8:1 14:1 19:1 20:2 21:2 22:1 23:1 24:5 25:5 26:3 27:2 28:6 29:8 30:80 31:28 32:26 33:7 36:1 43:1 54:1 55:1 56:1 58:1 59:3 64:5 66:2 68:1 70:1 73:1 74:1 79:2 84:8 86:5 87:21 88:4 89:1 90:10 91:2 92:3 93:11 94:4
SeqPrep,gen_n1000000_l209_merged.fq.gz,1000000,209,999910,818556,181354,0.128,0:635896 1:160605 2:19954 3:1674 4:121 12:2 15:1 16:1 18:1 19:1 20:4 21:2 22:5 23:6 24:7 25:9 26:9 27:8 28:13 29:20 30:93 31:46 32:4 33:1 35:1 38:2 39:1 53:1 59:1 61:1 62:1 64:3 67:2 68:3 70:1 82:1 85:1 86:5 87:13 88:6 89:2 90:9 92:2 93:11 94:4 95:2
SeqPrep,gen_n1000000_l20_merged.fq.gz,1000000,20,999917,1000000,-83,0.022,0:995637 1:4359 2:4
SeqPrep,gen_n1000000_l210_merged.fq.gz,1000000,210,999916,821940,177976,0.131,0:636163 1:163131 2:20485 3:1679 4:106 5:7 10:1 12:1 17:1 18:1 20:2 21:3 23:6 24:6 25:12 26:15 27:6 28:16 29:11 30:137 31:28 32:2 33:2 34:2 35:1 36:2 37:1 39:1 41:1 47:1 48:1 49:1 57:1 61:1 62:3 64:6 66:3 72:1 75:1 76:2 78:1 80:1 82:1 84:1 85:1 86:3 87:15 88:8 89:1 90:14 91:1 92:4 93:6 94:12 95:1 96:20
SeqPrep,gen_n1000000_l211_merged.fq.gz,1000000,211,999931,824549,175382,0.13,0:635721 1:165312 2:21335 3:1811 4:119 5:4 8:1 10:1 12:1 15:2 18:2 20:7 21:2 22:4 23:5 24:7 25:33 26:32 27:10 28:15 29:19 30:7 31:2 32:4 33:1 34:1 35:1 36:2 37:1 43:1 46:1 53:2 54:1 55:1 56:1 64:2 66:1 67:2 68:1 70:1 72:1 77:1 81:1 87:14 88:6 90:9 91:1 92:3 93:11 94:5 95:2 96:17 97:2
SeqPrep,gen_n1000000_l212_merged.fq.gz,1000000,212,999910,828023,171887,0.13,0:636026 1:168082 2:21679 3:1885 4:115 5:6 15:1 16:3 18:1 19:4 20:4 21:1 22:8 23:7 24:6 25:36 26:33 27:12 28:21 29:5 30:1 34:1 35:1 36:2 38:1 39:1 45:1 50:1 51:1 53:1 59:1 60:1 61:1 62:2 63:1 64:1 69:1 70:1 78:1 79:1 80:2 86:1 87:1 88:2 89:1 90:9 92:7 93:12 94:7 95:2 96:15 97:4 98:3
SeqPrep,gen_n1000000_l213_merged.fq.gz,1000000,213,999900,831088,168812,0.132,0:636665 1:169714 2:22305 3:2023 4:131 5:3 6:1 10:1 15:2 16:2 18:2 19:1 20:3 21:1 22:3 23:8 24:12 25:54 26:30 27:19 28:4 29:1 32:1 34:2 35:1 36:1 37:1 38:1 39:2 40:2 41:1 42:1 44:1 60:1 63:1 64:7 67:2 69:1 75:1 76:1 83:1 89:1 90:5 91:4 92:4 93:12 94:6 95:3 96:21 97:1 98:7 99:10
SeqPrep,gen_n1000000_l214_merged.fq.gz,1000000,214,999937,832849,167088,0.134,0:634864 1:172083 2:23405 3:2040 4:137 5:6 8:1 14:1 15:1 16:2 17:1 18:2 19:6 20:9 21:5 22:4 23:9 24:17 25:84 26:69 27:15 29:1 30:1 31:2 34:1 35:1 36:1 39:1 45:1 50:1 51:1 52:1 54:1 56:1 57:1 58:1 59:1 64:3 65:1 67:2 68:1 70:1 74:1 77:1 78:1 82:1 84:1 87:2 90:5 91:1 92:3 93:9 94:4 95:2 96:15 97:3 98:4 99:6 100:4
SeqPrep,gen_n1000000_l215_merged.fq.gz,1000000,215,999920,837277,162643,0.134,0:635550 1:175005 2:24055 3:2269 4:130 5:7 11:1 15:1 16:6 17:1 18:4 19:1 20:18 21:3 22:6 23:16 24:26 25:73 26:20 27:1 28:4 29:1 35:1 36:1 41:1 44:1 45:1 51:2 54:1 55:1 56:1 59:1 61:1 62:1 64:2 66:2 68:1 69:1 70:1 72:1 80:1 84:2 85:1 87:1 88:1 91:1 92:4 93:7 94:6 95:1 96:11 97:6 98:4 99:6 100:5 213:1
SeqPrep,gen_n1000000_l216_merged.fq.gz,1000000,216,999907,841796,158111,0.135,0:637090 1:177262 2:24815 3:2247 4:150 5:16 15:1 16:2 18:6 19:4 20:22 21:13 22:3 23:21 24:35 25:3 26:1 28:1 29:1 31:2 32:1 34:3 36:1 40:2 44:1 48:1 52:1 53:1 57:1 66:2 72:1 76:1 80:1 85:1 87:1 88:1 92:4 93:9 94:8 95:3 96:10 97:2 98:7 99:13 100:7 102:17 103:1
SeqPrep,gen_n1000000_l217_merged.fq.gz,1000000,217,999922,844495,155427,0.137,0:635146 1:180639 2:25865 3:2443 4:176 5:7 7:1 12:1 14:1 15:1 16:2 17:2 18:4 19:3 20:38 21:16 22:8 23:39 24:10 25:2 26:1 27:2 28:1 30:1 31:1 32:1 34:1 38:1 44:1 52:1 55:1 56:1 57:1 60:1 62:2 68:1 74:1 84:1 93:12 94:4 95:1 96:17 97:1 98:4 99:10 100:6 101:1 102:14 103:1
SeqPrep,gen_n1000000_l218_merged.fq.gz,1000000,218,999919,847594,152325,0.138,0:634987 1:183360 2:26322 3:2542 4:175 5:12 6:1 7:1 12:1 13:1 15:2 16:3 18:4 19:4 20:47 21:20 22:10 23:5 24:2 25:1 27:1 28:1 30:1 33:2 34:1 37:1 38:1 39:1 40:1 43:1 44:1 49:1 57:1 59:1 61:1 62:2 64:2 68:1 69:1 73:1 78:1 81:1 87:2 88:1 94:6 96:7 97:2 98:3 99:14 100:5 102:22 103:1 104:6
SeqPrep,gen_n1000000_l219_merged.fq.gz,1000000,219,999918,850960,148958,0.14,0:635145 1:185518 2:27167 3:2675 4:215 5:16 6:1 8:1 12:3 14:2 15:2 16:3 17:3 18:5 19:6 20:56 21:25 22:3 24:3 25:1 28:1 29:1 31:3 32:1 33:1 34:1 36:1 41:1 43:1 45:1 52:1 61:1 62:1 64:2 67:1 71:1 76:1 77:1 78:1 85:2 86:2 93:1 95:1 96:12 97:2 98:4 99:15 100:2 101:3 102:25 103:1 104:10 105:8
SeqPrep,gen_n1000000_l21_merged.fq.gz,1000000,21,999934,1000000,-66,0.022,0:995450 1:4543 2:7
SeqPrep,gen_n1000000_l220_merged.fq.gz,1000000,220,999916,854481,145435,0.141,0:635312 1:188443 2:27568 3:2678 4:228 5:16 14:1 15:6 16:3 17:1 18:11 19:9 20:74 21:11 22:5 24:2 25:2 27:1 28:4 30:1 31:1 34:1 37:1 42:1 47:1 48:1 50:1 54:1 64:1 70:1 76:3 80:1 82:1 84:2 86:1 93:1 96:14 98:5 99:10 100:9 102:16 104:11 105:9 106:12
SeqPrep,gen_n1000000_l221_merged.fq.gz,1000000,221,999924,858547,141377,0.141,0:635183 1:191596 2:28564 3:2823 4:212 5:10 7:1 10:1 12:1 13:1 14:1 15:19 16:9 17:5 18:17 19:8 20:2 24:2 28:2 39:1 40:1 41:1 48:1 49:1 52:1 61:1 63:1 67:1 69:1 77:1 78:2 80:1 84:1 87:1 90:1 92:1 97:2 98:2 99:12 100:5 102:26 104:5 105:12 106:8
SeqPrep,gen_n1000000_l222_merged.fq.gz,1000000,222,999924,862868,137056,0.143,0:635819 1:194507 2:29167 3:2971 4:212 5:18 6:1 10:2 14:2 15:21 16:12 17:10 18:11 19:5 23:1 28:4 31:1 32:3 44:1 48:2 50:1 57:2 59:1 60:1 63:1 64:3 66:1 74:1 76:1 78:1 81:1 88:1 98:6 99:11 100:5 101:1 102:22 104:4 105:7 106:11 108:16
SeqPrep,gen_n1000000_l223_merged.fq.gz,1000000,223,999932,865419,134513,0.145,0:634056 1:197313 2:30469 3:3123 4:243 5:12 6:1 9:2 10:4 12:2 13:1 14:3 15:37 16:25 17:12 18:1 26:1 27:1 28:2 30:2 31:2 32:1 35:1 39:1 44:1 46:1 51:1 64:2 67:3 69:1 72:1 73:1 78:1 79:1 80:1 88:1 90:1 91:1 99:13 100:5 101:1 102:27 104:3 105:11 106:9 108:18
SeqPrep,gen_n1000000_l224_merged.fq.gz,1000000,224,999922,869452,130470,0.144,0:635344 1:199399 2:31030 3:3235 4:254 5:18 6:1 8:2 10:3 11:1 12:3 13:1 14:3 15:37 16:39 17:2 18:2 24:3 28:3 29:2 30:2 31:1 32:2 34:1 35:2 38:1 39:1 44:1 49:1 54:1 57:1 58:1 62:2 63:1 67:1 74:1 80:1 84:2 93:1 100:2 102:14 104:7 105:5 106:8 108:3 109:3 110:4
SeqPrep,gen_n1000000_l225_merged.fq.gz,1000000,225,999911,872630,127281,0.147,0:633546 1:203104 2:32125 3:3377 4:262 5:26 8:1 9:1 10:2 12:8 13:4 14:5 15:60 16:18 17:3 27:1 29:1 30:1 32:2 33:1 34:3 37:1 40:2 41:1 50:1 55:1 66:1 70:1 78:2 88:1 99:1 101:1 102:19 103:2 104:9 105:12 106:3 107:1 108:9 109:1 110:4 111:6
SeqPrep,gen_n1000000_l226_merged.fq.gz,1000000,226,999920,877532,122388,0.148,0:634720 1:205767 2:33001 3:3583 4:272 5:19 6:3 7:1 9:2 10:24 11:10 12:8 13:5 14:12 15:1 26:1 27:1 30:3 31:1 32:3 35:2 37:1 42:1 49:1 50:1 64:2 76:1 79:1 84:1 87:1 88:1 90:1 96:2 97:1 102:18 104:10 105:7 106:7 107:1 108:14 110:4 111:7 112:10
SeqPrep,gen_n1000000_l227_merged.fq.gz,1000000,227,999921,880979,118942,0.149,0:634972 1:207784 2:34093 3:3651 4:298 5:14 9:1 10:31 11:9 12:23 13:14 14:3 15:2 28:1 30:1 31:1 35:1 36:1 42:1 47:1 48:1 59:1 64:1 66:1 68:1 77:1 78:1 84:2 86:1 94:1 96:3 101:1 103:1 104:2 105:5 106:6 107:1 108:15 109:3 110:5 111:7 112:17
SeqPrep,gen_n1000000_l228_merged.fq.gz,1000000,228,999925,884566,115359,0.152,0:633005 1:211850 2:35319 3:3889 4:313 5:20 6:2 7:2 8:1 9:3 10:32 11:10 12:17 13:2 14:1 30:1 31:1 32:1 33:4 34:1 35:1 36:1 37:1 40:2 41:1 45:1 46:1 61:1 63:1 64:2 77:1 78:2 82:1 87:1 88:1 93:1 97:1 98:1 104:4 105:3 106:11 108:13 109:1 110:3 111:6 112:11 114:18 128:1
SeqPrep,gen_n1000000_l229_merged.fq.gz,1000000,229,999915,888801,111114,0.151,0:634167 1:213833 2:36242 3:4084 4:315 5:20 6:3 8:6 9:5 10:31 11:13 12:3 29:1 31:3 32:2 34:1 37:1 39:2 42:1 43:1 50:1 51:1 68:1 84:1 88:2 90:2 104:1 105:5 106:6 107:1 108:12 110:2 111:7 112:11 113:2 114:10 115:1 124:1
SeqPrep,gen_n1000000_l22_merged.fq.gz,1000000,22,999918,1000000,-82,0.022,0:995258 1:4736 2:6
SeqPrep,gen_n1000000_l230_merged.fq.gz,1000000,230,999909,892492,107417,0.153,0:633910 1:216999 2:36951 3:4059 4:371 5:28 6:6 7:1 8:6 9:6 10:56 11:17 12:2 32:1 33:1 35:1 36:2 40:3 48:1 54:1 64:2 66:1 73:1 79:1 80:1 87:1 102:1 106:8 108:13 110:6 111:4 112:10 114:9 115:2 116:10
SeqPrep,gen_n1000000_l231_merged.fq.gz,1000000,231,999908,897250,102658,0.154,0:633549 1:221012 2:37753 3:4378 4:384 5:59 6:12 7:3 8:8 9:7 10:3 20:1 32:1 34:2 36:1 37:1 42:1 50:1 51:1 56:3 63:1 64:1 66:2 70:1 95:1 97:1 107:2 108:14 110:4 111:2 112:8 113:1 114:13 115:3 116:10 117:6
SeqPrep,gen_n1000000_l232_merged.fq.gz,1000000,232,999927,900920,99007,0.155,0:633443 1:223489 2:38912 3:4492 4:380 5:77 6:17 7:3 8:20 9:4 32:3 33:1 34:3 36:3 37:1 39:1 42:2 52:1 60:1 61:1 64:1 67:1 80:1 92:1 102:1 108:7 109:1 110:5 111:6 112:12 113:1 114:10 115:2 116:6 117:6 118:5
SeqPrep,gen_n1000000_l233_merged.fq.gz,1000000,233,999907,903879,96028,0.158,0:632273 1:226236 2:39919 3:4779 4:461 5:63 6:37 7:12 8:2 33:2 35:1 36:1 38:1 39:1 44:1 45:1 46:1 48:1 51:1 53:1 63:1 64:1 65:1 67:1 75:1 85:1 86:1 87:1 88:1 96:1 98:1 100:1 102:1 105:1 109:2 110:3 111:7 112:18 114:16 115:3 116:9 117:7 118:3 119:3
SeqPrep,gen_n1000000_l234_merged.fq.gz,1000000,234,999922,908455,91467,0.159,0:631977 1:229642 2:41312 3:4885 4:433 5:80 6:34 7:6 8:2 11:1 35:1 36:1 38:1 39:1 40:1 42:1 51:1 52:1 53:1 63:1 75:1 79:1 85:1 99:1 100:1 110:2 111:2 112:9 113:1 114:15 116:15 117:3 118:4 119:1 120:15 132:1
SeqPrep,gen_n1000000_l235_merged.fq.gz,1000000,235,999915,912131,87784,0.161,0:632253 1:231730 2:42315 3:5108 4:504 5:102 6:19 7:4 10:1 35:1 36:2 38:2 39:3 48:1 49:2 57:1 58:1 60:1 62:1 66:1 96:1 98:1 102:1 111:3 112:12 113:1 114:11 116:12 117:4 118:4 119:4 120:24 148:1
SeqPrep,gen_n1000000_l236_merged.fq.gz,1000000,236,999917,918025,81892,0.161,0:632564 1:235919 2:43588 3:5333 4:502 5:41 6:2 13:1 20:1 36:1 37:1 39:1 41:1 42:1 43:1 46:1 47:1 59:1 60:1 68:1 78:1 80:1 93:1 94:1 99:1 103:1 112:7 113:1 114:9 115:1 116:12 117:3 118:4 119:2 120:15 122:3
SeqPrep,gen_n1000000_l237_merged.fq.gz,1000000,237,999921,922655,77266,0.163,0:632559 1:238938 2:44857 3:5626 4:550 5:45 6:3 10:1 37:1 38:2 39:1 44:1 59:1 63:1 64:1 68:1 69:1 72:1 90:1 92:1 96:1 113:4 114:14 115:2 116:8 117:3 118:1 120:22 121:1 122:2 123:5
SeqPrep,gen_n1000000_l238_merged.fq.gz,1000000,238,999925,926569,73356,0.164,0:632573 1:241882 2:45609 3:5836 4:534 5:45 6:4 7:1 10:1 20:1 38:1 39:2 41:1 56:1 57:1 60:2 61:1 64:1 67:1 71:1 75:1 82:1 88:1 102:1 112:1 114:8 116:11 117:8 118:3 120:15 122:3 123:7 124:11
SeqPrep,gen_n1000000_l239_merged.fq.gz,1000000,239,999926,931023,68903,0.165,0:632742 1:244415 2:47164 3:6025 4:550 5:49 11:1 22:1 40:1 50:1 53:1 57:2 64:2 82:1 114:1 116:8 117:8 118:7 119:3 120:14 121:2 122:3 123:7 124:11 125:4
SeqPrep,gen_n1000000_l23_merged.fq.gz,1000000,23,999913,1000000,-87,0.021,0:995084 1:4905 2:11
SeqPrep,gen_n1000000_l240_merged.fq.gz,1000000,240,999921,936108,63813,0.167,0:631972 1:248437 2:48708 3:6210 4:642 5:53 6:5 8:1 10:1 15:1 42:1 44:1 46:1 52:2 56:2 57:1 64:1 69:1 78:1 109:1 116:3 117:5 118:2 120:17 122:3 123:9 124:10 125:2 126:15
SeqPrep,gen_n1000000_l241_merged.fq.gz,1000000,241,999922,2912,997010,6.4,1:344 2:310 3:148 4:230 5:869 6:313 7:56 8:21 9:2 10:9 11:8 12:6 13:1 14:4 15:8 16:6 17:4 18:6 19:5 20:11 21:6 22:8 23:10 24:6 25:4 26:16 27:7 28:15 29:11 30:13 31:7 32:8 33:4 34:11 35:5 36:8 37:6 38:7 39:5 40:8 41:10 42:22 43:9 44:12 45:4 46:8 47:9 48:11 49:9 50:8 51:5 52:7 53:3 54:7 55:3 56:8 57:1 58:1 59:1 60:5 61:1 62:5 63:6 64:32 65:2 66:7 67:3 68:5 69:1 70:4 71:1 72:3 73:3 74:3 76:3 77:3 78:3 79:1 80:2 81:2 83:3 84:2 85:5 86:1 87:5 88:4 90:1 91:7 92:1 93:1 94:1 95:1 96:5 97:1 98:2 100:2 101:2 102:3 103:1 104:1 105:1 106:4 107:1 108:3 109:3 110:2 112:3 113:1 114:5 115:3 116:4 117:7 118:9 120:15 121:3 122:5 123:6 124:8 125:1 126:17 127:3
SeqPrep,gen_n1000000_l242_merged.fq.gz,1000000,242,999910,3087,996823,6.474,2:452 3:287 4:276 5:971 6:369 7:82 8:12 9:5 10:13 11:1 12:5 13:6 14:6 15:12 16:4 17:7 18:10 19:3 20:11 21:7 22:4 23:6 24:12 25:10 26:10 27:13 28:12 29:14 30:10 31:9 32:9 33:3 34:12 35:6 36:6 37:4 38:3 39:4 40:3 41:1 42:28 43:7 44:8 45:6 46:7 47:2 48:6 49:8 50:6 51:8 52:6 53:6 54:7 55:5 56:3 57:6 58:5 59:1 60:5 61:5 62:3 63:4 64:27 65:7 66:7 67:6 68:8 69:3 70:1 71:2 72:4 73:4 74:3 75:3 76:4 77:4 78:1 80:3 81:2 82:2 85:4 86:1 87:6 88:2 89:1 90:2 92:3 93:2 94:2 95:2 96:5 97:2 98:4 99:2 100:4 102:6 103:2 104:3 105:4 106:1 107:2 108:1 110:1 111:1 112:2 114:8 115:1 116:1 118:7 120:17 122:4 123:5 124:15 125:5 126:10 128:26
SeqPrep,gen_n1000000_l243_merged.fq.gz,1000000,243,999926,3187,996739,6.482,3:333 4:531 5:1147 6:404 7:90 8:33 9:12 10:22 11:2 12:9 13:8 14:5 15:20 16:7 17:2 18:8 19:7 20:12 21:11 22:5 23:10 24:6 25:6 26:12 27:8 28:9 29:11 30:19 31:4 32:9 33:4 34:9 35:4 36:7 37:6 38:4 39:3 40:5 41:5 42:4 43:4 44:8 45:11 46:8 47:5 48:7 49:11 50:6 51:4 52:5 53:5 54:2 55:8 56:9 57:4 58:4 59:3 60:9 61:6 62:1 63:1 64:23 65:5 66:6 67:6 68:5 69:4 70:6 71:3 72:2 73:4 74:1 75:4 76:4 77:1 78:2 79:1 80:4 84:4 85:6 86:2 87:4 88:1 90:3 91:1 92:3 93:1 94:1 95:1 96:1 97:3 98:3 99:1 102:7 103:2 105:3 106:2 108:3 110:1 111:2 112:3 114:9 116:1 117:1 118:2 119:2 120:16 121:1 122:5 123:3 124:14 125:1 126:11 127:2 128:41 129:4 143:1
SeqPrep,gen_n1000000_l244_merged.fq.gz,1000000,244,999921,3446,996475,5.943,4:656 5:1415 6:518 7:128 8:37 9:15 10:20 11:8 12:12 13:9 14:7 15:20 16:12 17:11 18:9 19:4 20:12 21:9 22:10 23:12 24:14 25:6 26:17 27:14 28:14 29:10 30:16 31:13 32:13 33:9 34:7 35:2 36:14 37:5 38:5 39:5 40:13 41:2 42:7 43:1 44:16 45:10 46:10 47:2 48:7 49:7 50:6 51:4 52:6 53:6 54:6 55:10 56:6 57:6 58:4 59:2 60:3 61:3 62:3 63:5 64:25 65:4 66:6 67:7 68:4 69:1 70:3 72:1 73:2 74:1 75:2 76:1 77:4 78:4 80:2 81:1 82:3 83:1 84:2 85:7 87:1 88:2 90:1 91:2 93:2 95:2 96:3 97:3 99:4 101:1 102:7 103:2 104:3 105:1 106:1 107:1 110:1 111:1 112:2 114:8 115:1 116:3 117:1 118:1 119:1 120:8 121:1 122:5 123:5 124:9 125:1 126:7 127:1 128:28 129:4 130:8
SeqPrep,gen_n1000000_l245_merged.fq.gz,1000000,245,999908,3361,996547,6.559,5:1450 6:733 7:209 8:182 9:60 10:32 11:11 12:10 13:3 14:7 15:12 16:10 17:11 18:10 19:6 20:12 21:18 22:4 23:8 24:7 25:10 26:11 27:14 28:15 29:13 30:17 31:14 32:16 33:6 34:15 35:14 36:11 37:6 38:2 39:12 40:7 41:5 42:10 43:2 44:4 45:10 46:10 47:6 48:7 49:12 50:7 51:4 52:1 53:9 54:10 55:5 56:5 57:1 58:7 59:5 60:7 61:3 62:7 63:4 64:26 65:4 66:4 67:8 68:7 69:4 70:3 71:3 72:8 73:2 74:4 75:5 76:4 77:3 78:1 79:1 80:2 81:1 82:4 83:1 84:4 85:2 86:2 87:6 88:3 89:3 90:4 91:3 94:1 96:1 97:2 98:2 99:1 100:4 101:1 102:8 103:1 104:2 105:2 106:2 107:2 109:1 111:1 112:2 114:4 115:2 116:1 117:1 118:2 120:2 122:2 123:4 124:15 126:12 127:1 128:31 129:5 130:3 131:1 143:1
SeqPrep,gen_n1000000_l246_merged.fq.gz,1000000,246,999926,2280,997646,9.605,6:419 7:214 8:164 9:69 10:476 11:174 12:40 13:19 14:11 15:17 16:9 17:10 18:13 19:7 20:18 21:4 22:10 23:13 24:22 25:15 26:7 27:11 28:22 29:13 30:18 31:10 32:14 33:5 34:11 35:12 36:9 37:4 38:10 39:4 40:9 41:4 42:14 43:4 44:6 45:5 46:7 47:7 48:7 49:6 50:11 51:3 52:9 53:3 54:10 55:5 56:11 57:4 58:6 59:2 60:7 61:5 62:4 63:12 64:18 65:7 66:4 67:7 68:5 69:3 70:5 71:2 72:2 74:4 75:4 76:5 77:5 78:5 80:4 81:1 82:1 83:2 84:4 86:2 87:5 89:2 90:3 91:3 93:1 95:2 96:2 97:5 98:4 101:2 102:5 104:2 105:2 106:2 107:1 108:1 110:2 111:1 112:2 113:2 114:5 115:2 116:1 117:4 118:1 119:1 120:5 121:1 122:3 123:2 124:15 125:1 126:9 127:1 128:25 129:8 130:6 131:3 132:13
SeqPrep,gen_n1000000_l247_merged.fq.gz,1000000,247,999918,2220,997698,9.63,7:167 8:328 9:157 10:578 11:210 12:56 13:20 14:7 15:27 16:16 17:9 18:19 19:7 20:26 21:13 22:14 23:19 24:12 25:8 26:9 27:10 28:10 29:8 30:17 31:15 32:10 33:9 34:8 35:10 36:15 37:9 38:1 39:10 40:7 41:7 42:6 43:4 44:10 45:3 46:7 47:7 48:10 49:11 50:8 51:12 52:8 53:9 54:8 55:11 56:6 57:4 58:4 60:5 61:1 62:4 63:6 64:23 65:5 66:7 67:5 68:6 69:2 70:4 72:3 74:5 75:3 76:2 77:2 78:1 79:2 80:5 81:1 82:5 84:3 85:1 86:3 87:6 88:3 90:2 91:2 92:1 93:3 96:1 97:1 98:1 100:6 101:1 102:7 104:2 106:3 108:1 109:1 110:1 112:1 114:8 115:1 117:1 119:2 120:3 121:1 122:2 123:3 124:5 125:2 126:6 127:2 128:42 129:3 130:3 132:13
SeqPrep,gen_n1000000_l248_merged.fq.gz,1000000,248,999911,2468,997443,9.603,8:410 9:230 10:721 11:221 12:60 13:32 14:22 15:27 16:21 17:11 18:23 19:9 20:21 21:18 22:11 23:18 24:21 25:10 26:20 27:13 28:17 29:8 30:19 31:11 32:10 33:10 34:16 35:7 36:12 37:10 38:18 39:5 40:12 41:4 42:7 43:4 44:7 45:4 46:3 47:4 48:19 49:11 50:8 51:8 52:8 53:5 54:8 55:7 56:6 57:5 58:3 59:2 60:5 61:2 62:5 63:8 64:30 65:7 66:2 67:3 68:4 69:5 70:5 71:3 72:5 73:1 74:5 75:1 76:5 77:2 78:2 79:2 80:2 83:1 84:2 85:3 86:1 87:4 88:1 90:4 92:2 93:2 94:2 95:4 96:2 97:2 98:1 99:3 101:3 102:6 105:3 106:4 108:1 109:1 110:4 111:1 112:2 113:1 114:6 115:1 116:1 117:3 119:1 120:2 121:1 122:3 123:2 124:10 125:2 126:10 127:1 128:33 129:2 130:6 132:17 133:2 134:4
SeqPrep,gen_n1000000_l249_merged.fq.gz,1000000,249,999912,2449,997463,9.997,9:154 10:888 11:333 12:164 13:66 14:32 15:38 16:25 17:15 18:20 19:10 20:35 21:23 22:9 23:25 24:14 25:16 26:17 27:14 28:8 29:13 30:23 31:8 32:17 33:10 34:12 35:12 36:8 37:11 38:9 39:5 40:7 41:4 42:12 43:8 44:2 45:8 46:6 47:6 48:6 49:9 50:9 51:4 52:5 53:5 54:9 55:4 56:9 57:4 58:4 59:7 60:6 61:5 62:10 63:5 64:28 65:4 66:4 67:6 68:3 69:2 70:4 71:3 72:2 73:1 74:5 75:2 76:7 77:6 78:3 79:3 80:2 81:2 83:2 84:4 85:8 87:2 89:2 90:2 92:1 93:2 94:7 95:1 97:2 98:1 99:5 100:3 102:15 105:2 106:1 108:2 110:3 111:1 112:2 113:1 114:9 115:1 116:1 117:1 118:1 120:5 122:2 123:1 126:14 127:2 128:27 129:2 130:6 131:3 132:14 133:3 134:3 135:10
SeqPrep,gen_n1000000_l24_merged.fq.gz,1000000,24,999929,1000000,-71,0.021,0:994890 1:5098 2:12
SeqPrep,gen_n1000000_l250_merged.fq.gz,1000000,250,999916,2531,997385,10.095,10:932 11:412 12:230 13:75 14:29 15:40 16:33 17:22 18:23 19:13 20:40 21:22 22:16 23:23 24:23 25:19 26:22 27:15 28:16 29:13 30:19 31:11 32:15 33:7 34:11 35:9 36:12 37:7 38:5 39:5 40:9 41:4 42:11 43:4 44:4 45:4 46:3 47:4 48:6 49:4 50:5 51:5 52:7 53:2 54:10 55:3 56:6 57:8 58:2 59:3 60:6 61:8 62:8 63:9 64:25 65:5 66:3 67:4 68:2 69:6 70:6 71:4 72:7 73:2 74:3 75:4 76:4 77:2 78:3 79:1 80:4 81:2 82:2 83:2 84:1 85:3 86:4 87:2 88:2 90:5 91:2 92:2 93:2 94:1 95:1 96:3 97:1 98:1 100:3 102:16 103:1 105:2 106:4 107:1 108:1 110:4 111:1 112:1 113:1 114:8 117:2 118:1 119:1 120:1 121:1 122:1 123:2 124:1 126:10 127:2 128:36 129:1 130:3 131:1 132:14 133:1 134:13 135:12 136:10
SeqPrep,gen_n1000000_l25_merged.fq.gz,1000000,25,999922,1000000,-78,0.022,0:994610 1:5377 2:13
SeqPrep,gen_n1000000_l26_merged.fq.gz,1000000,26,999912,1000000,-88,0.021,0:994532 1:5454 2:14
SeqPrep,gen_n1000000_l27_merged.fq.gz,1000000,27,999930,1000000,-70,0.021,0:994299 1:5687 2:14
SeqPrep,gen_n1000000_l28_merged.fq.gz,1000000,28,999922,1000000,-78,0.021,0:994053 1:5922 2:25
SeqPrep,gen_n1000000_l29_merged.fq.gz,1000000,29,999909,1000000,-91,0.021,0:993910 1:6077 2:13
SeqPrep,gen_n1000000_l2_merged.fq.gz,1000000,2,999928,1000000,-72,0.046,0:999085 1:914 2:1
SeqPrep,gen_n1000000_l30_merged.fq.gz,1000000,30,999937,1000000,-63,0.021,0:993761 1:6225 2:14
SeqPrep,gen_n1000000_l31_merged.fq.gz,1000000,31,999928,1000000,-72,0.021,0:993370 1:6610 2:20
SeqPrep,gen_n1000000_l32_merged.fq.gz,1000000,32,999921,1000000,-79,0.021,0:993307 1:6674 2:19
SeqPrep,gen_n1000000_l33_merged.fq.gz,1000000,33,999929,1000000,-71,0.021,0:993167 1:6816 2:17
SeqPrep,gen_n1000000_l34_merged.fq.gz,1000000,34,999934,1000000,-66,0.021,0:992904 1:7071 2:25
SeqPrep,gen_n1000000_l35_merged.fq.gz,1000000,35,999903,1000000,-97,0.021,0:992547 1:7431 2:22
SeqPrep,gen_n1000000_l36_merged.fq.gz,1000000,36,999918,1000000,-82,0.021,0:992566 1:7404 2:30
SeqPrep,gen_n1000000_l37_merged.fq.gz,1000000,37,999921,1000000,-79,0.021,0:992270 1:7696 2:34
SeqPrep,gen_n1000000_l38_merged.fq.gz,1000000,38,999917,1000000,-83,0.022,0:991853 1:8116 2:31
SeqPrep,gen_n1000000_l39_merged.fq.gz,1000000,39,999919,1000000,-81,0.021,0:991713 1:8257 2:30
SeqPrep,gen_n1000000_l3_merged.fq.gz,1000000,3,999926,1000000,-74,0.046,0:998605 1:1395
SeqPrep,gen_n1000000_l40_merged.fq.gz,1000000,40,999920,1000000,-80,0.021,0:991774 1:8190 2:36
SeqPrep,gen_n1000000_l41_merged.fq.gz,1000000,41,999900,1000000,-100,0.021,0:991271 1:8701 2:28
SeqPrep,gen_n1000000_l42_merged.fq.gz,1000000,42,999906,1000000,-94,0.021,0:991206 1:8761 2:33
SeqPrep,gen_n1000000_l43_merged.fq.gz,1000000,43,999921,1000000,-79,0.021,0:991095 1:8869 2:36
SeqPrep,gen_n1000000_l44_merged.fq.gz,1000000,44,999910,1000000,-90,0.021,0:990830 1:9118 2:52
SeqPrep,gen_n1000000_l45_merged.fq.gz,1000000,45,999912,1000000,-88,0.021,0:990565 1:9390 2:45
SeqPrep,gen_n1000000_l46_merged.fq.gz,1000000,46,999923,1000000,-77,0.021,0:990389 1:9563 2:48
SeqPrep,gen_n1000000_l47_merged.fq.gz,1000000,47,999928,1000000,-72,0.021,0:990166 1:9783 2:51
SeqPrep,gen_n1000000_l48_merged.fq.gz,1000000,48,999923,1000000,-77,0.021,0:989883 1:10066 2:51
SeqPrep,gen_n1000000_l49_merged.fq.gz,1000000,49,999925,1000000,-75,0.021,0:989696 1:10253 2:50 3:1
SeqPrep,gen_n1000000_l4_merged.fq.gz,1000000,4,999896,1000000,-104,0.043,0:998266 1:1732 2:2
SeqPrep,gen_n1000000_l50_merged.fq.gz,1000000,50,999927,1000000,-73,0.022,0:989304 1:10636 2:60
SeqPrep,gen_n1000000_l51_merged.fq.gz,1000000,51,999919,1000000,-81,0.021,0:989381 1:10566 2:53
SeqPrep,gen_n1000000_l52_merged.fq.gz,1000000,52,999920,1000000,-80,0.021,0:989100 1:10841 2:59
SeqPrep,gen_n1000000_l53_merged.fq.gz,1000000,53,999912,1000000,-88,0.021,0:988902 1:11028 2:70
SeqPrep,gen_n1000000_l54_merged.fq.gz,1000000,54,999922,1000000,-78,0.021,0:988733 1:11200 2:67
SeqPrep,gen_n1000000_l55_merged.fq.gz,1000000,55,999914,1000000,-86,0.021,0:988556 1:11382 2:62
SeqPrep,gen_n1000000_l56_merged.fq.gz,1000000,56,999916,1000000,-84,0.021,0:988160 1:11771 2:69
SeqPrep,gen_n1000000_l57_merged.fq.gz,1000000,57,999900,1000000,-100,0.021,0:988102 1:11822 2:75 3:1
SeqPrep,gen_n1000000_l58_merged.fq.gz,1000000,58,999915,1000000,-85,0.021,0:987631 1:12304 2:65
SeqPrep,gen_n1000000_l59_merged.fq.gz,1000000,59,999905,1000000,-95,0.021,0:987562 1:12352 2:86
SeqPrep,gen_n1000000_l5_merged.fq.gz,1000000,5,999925,1000000,-75,0.045,0:997734 1:2266
SeqPrep,gen_n1000000_l60_merged.fq.gz,1000000,60,999917,1000000,-83,0.021,0:987438 1:12491 2:71
SeqPrep,gen_n1000000_l61_merged.fq.gz,1000000,61,999918,1000000,-82,0.021,0:987302 1:12616 2:82
SeqPrep,gen_n1000000_l62_merged.fq.gz,1000000,62,999910,1000000,-90,0.021,0:987013 1:12912 2:74 3:1
SeqPrep,gen_n1000000_l63_merged.fq.gz,1000000,63,999911,1000000,-89,0.021,0:986829 1:13093 2:78
SeqPrep,gen_n1000000_l64_merged.fq.gz,1000000,64,999922,1000000,-78,0.021,0:986349 1:13571 2:80
SeqPrep,gen_n1000000_l65_merged.fq.gz,1000000,65,999920,1000000,-80,0.021,0:986197 1:13725 2:77 3:1
SeqPrep,gen_n1000000_l66_merged.fq.gz,1000000,66,999904,1000000,-96,0.021,0:986071 1:13835 2:94
SeqPrep,gen_n1000000_l67_merged.fq.gz,1000000,67,999925,1000000,-75,0.021,0:985931 1:13971 2:98
SeqPrep,gen_n1000000_l68_merged.fq.gz,1000000,68,999915,1000000,-85,0.021,0:985585 1:14308 2:106 3:1
SeqPrep,gen_n1000000_l69_merged.fq.gz,1000000,69,999916,1000000,-84,0.021,0:985345 1:14551 2:103 3:1
SeqPrep,gen_n1000000_l6_merged.fq.gz,1000000,6,999916,1000000,-84,0.037,0:997755 1:2242 2:3
SeqPrep,gen_n1000000_l70_merged.fq.gz,1000000,70,999901,1000000,-99,0.022,0:984907 1:14998 2:95
SeqPrep,gen_n1000000_l71_merged.fq.gz,1000000,71,999895,1000000,-105,0.021,0:984932 1:14959 2:108 3:1
SeqPrep,gen_n1000000_l72_merged.fq.gz,1000000,72,999909,1000000,-91,0.022,0:984363 1:15519 2:117 3:1
SeqPrep,gen_n1000000_l73_merged.fq.gz,1000000,73,999926,1000000,-74,0.021,0:984531 1:15359 2:110
SeqPrep,gen_n1000000_l74_merged.fq.gz,1000000,74,999914,1000000,-86,0.021,0:984240 1:15635 2:123 3:2
SeqPrep,gen_n1000000_l75_merged.fq.gz,1000000,75,999929,1000000,-71,0.022,0:983915 1:15969 2:116
SeqPrep,gen_n1000000_l76_merged.fq.gz,1000000,76,999914,1000000,-86,0.021,0:983785 1:16097 2:118
SeqPrep,gen_n1000000_l77_merged.fq.gz,1000000,77,999902,1000000,-98,0.021,0:983632 1:16245 2:122 3:1
SeqPrep,gen_n1000000_l78_merged.fq.gz,1000000,78,999918,1000000,-82,0.022,0:983218 1:16648 2:132 3:2
SeqPrep,gen_n1000000_l79_merged.fq.gz,1000000,79,999921,1000000,-79,0.021,0:983274 1:16572 2:154
SeqPrep,gen_n1000000_l7_merged.fq.gz,1000000,7,999912,1000000,-88,0.032,0:997791 1:2208 2:1
SeqPrep,gen_n1000000_l80_merged.fq.gz,1000000,80,999907,1000000,-93,0.021,0:983039 1:16807 2:154
SeqPrep,gen_n1000000_l81_merged.fq.gz,1000000,81,999923,1000000,-77,0.021,0:982783 1:17079 2:136 3:2
SeqPrep,gen_n1000000_l82_merged.fq.gz,1000000,82,999924,1000000,-76,0.022,0:982352 1:17499 2:148 3:1
SeqPrep,gen_n1000000_l83_merged.fq.gz,1000000,83,999923,1000000,-77,0.021,0:982425 1:17444 2:131
SeqPrep,gen_n1000000_l84_merged.fq.gz,1000000,84,999906,1000000,-94,0.021,0:982133 1:17706 2:160 3:1
SeqPrep,gen_n1000000_l85_merged.fq.gz,1000000,85,999916,1000000,-84,0.022,0:981544 1:18301 2:154 3:1
SeqPrep,gen_n1000000_l86_merged.fq.gz,1000000,86,999921,1000000,-79,0.022,0:981511 1:18314 2:174 3:1
SeqPrep,gen_n1000000_l87_merged.fq.gz,1000000,87,999935,1000000,-65,0.022,0:981101 1:18721 2:176 3:2
SeqPrep,gen_n1000000_l88_merged.fq.gz,1000000,88,999924,1000000,-76,0.022,0:981094 1:18722 2:182 3:2
SeqPrep,gen_n1000000_l89_merged.fq.gz,1000000,89,999911,1000000,-89,0.021,0:981174 1:18659 2:167
SeqPrep,gen_n1000000_l8_merged.fq.gz,1000000,8,999921,1000000,-79,0.029,0:997713 1:2281 2:6
SeqPrep,gen_n1000000_l90_merged.fq.gz,1000000,90,999923,1000000,-77,0.022,0:980747 1:19059 2:193 3:1
SeqPrep,gen_n1000000_l91_merged.fq.gz,1000000,91,999915,1000000,-85,0.022,0:980410 1:19401 2:188 3:1
SeqPrep,gen_n1000000_l92_merged.fq.gz,1000000,92,999916,1000000,-84,0.022,0:980155 1:19650 2:194 3:1
SeqPrep,gen_n1000000_l93_merged.fq.gz,1000000,93,999908,1000000,-92,0.022,0:979934 1:19861 2:203 3:2
SeqPrep,gen_n1000000_l94_merged.fq.gz,1000000,94,999916,1000000,-84,0.022,0:979705 1:20116 2:178 3:1
SeqPrep,gen_n1000000_l95_merged.fq.gz,1000000,95,999918,1000000,-82,0.022,0:979305 1:20496 2:196 3:3
SeqPrep,gen_n1000000_l96_merged.fq.gz,1000000,96,999915,1000000,-85,0.022,0:979115 1:20634 2:251
SeqPrep,gen_n1000000_l97_merged.fq.gz,1000000,97,999915,1000000,-85,0.022,0:978894 1:20894 2:212
SeqPrep,gen_n1000000_l98_merged.fq.gz,1000000,98,999919,1000000,-81,0.022,0:978537 1:21219 2:243 3:1
SeqPrep,gen_n1000000_l99_merged.fq.gz,1000000,99,999915,1000000,-85,0.022,0:978379 1:21406 2:209 3:6
SeqPrep,gen_n1000000_l9_merged.fq.gz,1000000,9,999911,1000000,-89,0.026,0:997700 1:2300
