program,filename,nfrags,fraglen,total_sequences,total_reads,dropped_reads,incorrect_length,correct_len_incorrect_seq,perfectly_reconstructed,dropped_reads_percentage,incorrect_length_percentage,correct_len_incorrect_seq_percentage,perfectly_reconstructed_percentage,divergent_reads,
bbmerge,gen_n1000000_l1000_merged.fq,1000000,1000,999921,881,999040,881,0,0,99.904,0.088,0.0,0.0,881,
bbmerge,gen_n1000000_l100_merged.fq,1000000,100,999928,985706,14222,0,29792,955914,1.422,0.0,2.979,95.591,29792,
bbmerge,gen_n1000000_l101_merged.fq,1000000,101,999921,983308,16613,0,29876,953432,1.661,0.0,2.988,95.343,29876,
bbmerge,gen_n1000000_l102_merged.fq,1000000,102,999926,984351,15575,0,30536,953815,1.558,0.0,3.054,95.382,30536,
bbmerge,gen_n1000000_l103_merged.fq,1000000,103,999915,984651,15264,0,30584,954067,1.526,0.0,3.058,95.407,30584,
bbmerge,gen_n1000000_l104_merged.fq,1000000,104,999911,984969,14942,0,30999,953970,1.494,0.0,3.1,95.397,30999,
bbmerge,gen_n1000000_l105_merged.fq,1000000,105,999920,984716,15204,0,31226,953490,1.52,0.0,3.123,95.349,31226,
bbmerge,gen_n1000000_l106_merged.fq,1000000,106,999938,984846,15092,0,31712,953134,1.509,0.0,3.171,95.313,31712,
bbmerge,gen_n1000000_l107_merged.fq,1000000,107,999913,985243,14670,0,32584,952659,1.467,0.0,3.258,95.266,32584,
bbmerge,gen_n1000000_l108_merged.fq,1000000,108,999922,986351,13571,0,32598,953753,1.357,0.0,3.26,95.375,32598,
bbmerge,gen_n1000000_l109_merged.fq,1000000,109,999923,988483,11440,0,33087,955396,1.144,0.0,3.309,95.54,33087,
bbmerge,gen_n1000000_l10_merged.fq,1000000,10,999901,510255,489646,0,4,510251,48.965,0.0,0.0,51.025,4,
bbmerge,gen_n1000000_l110_merged.fq,1000000,110,999916,988207,11709,0,33526,954681,1.171,0.0,3.353,95.468,33526,
bbmerge,gen_n1000000_l111_merged.fq,1000000,111,999908,986097,13811,0,33781,952316,1.381,0.0,3.378,95.232,33781,
bbmerge,gen_n1000000_l112_merged.fq,1000000,112,999924,987247,12677,0,34111,953136,1.268,0.0,3.411,95.314,34111,
bbmerge,gen_n1000000_l113_merged.fq,1000000,113,999914,987743,12171,0,34392,953351,1.217,0.0,3.439,95.335,34392,
bbmerge,gen_n1000000_l114_merged.fq,1000000,114,999932,988300,11632,0,35168,953132,1.163,0.0,3.517,95.313,35168,
bbmerge,gen_n1000000_l115_merged.fq,1000000,115,999935,989041,10894,0,35647,953394,1.089,0.0,3.565,95.339,35647,
bbmerge,gen_n1000000_l116_merged.fq,1000000,116,999926,987663,12263,0,35593,952070,1.226,0.0,3.559,95.207,35593,
bbmerge,gen_n1000000_l117_merged.fq,1000000,117,999917,988187,11730,0,36353,951834,1.173,0.0,3.635,95.183,36353,
bbmerge,gen_n1000000_l118_merged.fq,1000000,118,999936,989144,10792,0,36492,952652,1.079,0.0,3.649,95.265,36492,
bbmerge,gen_n1000000_l119_merged.fq,1000000,119,999928,990664,9264,0,37140,953524,0.926,0.0,3.714,95.352,37140,
bbmerge,gen_n1000000_l11_merged.fq,1000000,11,999928,810080,189848,0,7,810073,18.985,0.0,0.001,81.007,7,
bbmerge,gen_n1000000_l120_merged.fq,1000000,120,999913,989958,9955,0,37685,952273,0.996,0.0,3.769,95.227,37685,
bbmerge,gen_n1000000_l121_merged.fq,1000000,121,999915,988593,11322,0,37677,950916,1.132,0.0,3.768,95.092,37677,
bbmerge,gen_n1000000_l122_merged.fq,1000000,122,999926,988656,11270,0,38245,950411,1.127,0.0,3.825,95.041,38245,
bbmerge,gen_n1000000_l123_merged.fq,1000000,123,999926,989380,10546,0,38819,950561,1.055,0.0,3.882,95.056,38819,
bbmerge,gen_n1000000_l124_merged.fq,1000000,124,999907,989149,10758,0,39296,949853,1.076,0.0,3.93,94.985,39296,
bbmerge,gen_n1000000_l125_merged.fq,1000000,125,999938,988908,11030,0,39476,949432,1.103,0.0,3.948,94.943,39476,
bbmerge,gen_n1000000_l126_merged.fq,1000000,126,999918,986004,13914,0,41947,944057,1.391,0.0,4.195,94.406,41947,
bbmerge,gen_n1000000_l127_merged.fq,1000000,127,999911,985609,14302,0,44236,941373,1.43,0.0,4.424,94.137,44236,
bbmerge,gen_n1000000_l128_merged.fq,1000000,128,999924,985225,14699,0,46256,938969,1.47,0.0,4.626,93.897,46256,
bbmerge,gen_n1000000_l129_merged.fq,1000000,129,999908,984545,15363,0,48856,935689,1.536,0.0,4.886,93.569,48856,
bbmerge,gen_n1000000_l12_merged.fq,1000000,12,999912,864876,135036,0,7,864869,13.504,0.0,0.001,86.487,7,
bbmerge,gen_n1000000_l130_merged.fq,1000000,130,999922,984721,15201,0,51981,932740,1.52,0.0,5.198,93.274,51981,
bbmerge,gen_n1000000_l131_merged.fq,1000000,131,999914,983765,16149,0,54538,929227,1.615,0.0,5.454,92.923,54538,
bbmerge,gen_n1000000_l132_merged.fq,1000000,132,999903,982817,17086,0,57386,925431,1.709,0.0,5.739,92.543,57386,
bbmerge,gen_n1000000_l133_merged.fq,1000000,133,999924,982516,17408,0,59239,923277,1.741,0.0,5.924,92.328,59239,
bbmerge,gen_n1000000_l134_merged.fq,1000000,134,999910,982489,17421,0,61324,921165,1.742,0.0,6.132,92.117,61324,
bbmerge,gen_n1000000_l135_merged.fq,1000000,135,999914,983723,16191,0,63120,920603,1.619,0.0,6.312,92.06,63120,
bbmerge,gen_n1000000_l136_merged.fq,1000000,136,999919,982273,17646,0,65637,916636,1.765,0.0,6.564,91.664,65637,
bbmerge,gen_n1000000_l137_merged.fq,1000000,137,999921,982815,17106,0,67442,915373,1.711,0.0,6.744,91.537,67442,
bbmerge,gen_n1000000_l138_merged.fq,1000000,138,999916,982881,17035,0,69875,913006,1.704,0.0,6.988,91.301,69875,
bbmerge,gen_n1000000_l139_merged.fq,1000000,139,999922,981994,17928,0,72228,909766,1.793,0.0,7.223,90.977,72228,
bbmerge,gen_n1000000_l13_merged.fq,1000000,13,999925,892386,107539,0,7,892379,10.754,0.0,0.001,89.238,7,
bbmerge,gen_n1000000_l140_merged.fq,1000000,140,999928,982847,17081,0,74183,908664,1.708,0.0,7.418,90.866,74183,
bbmerge,gen_n1000000_l141_merged.fq,1000000,141,999935,980987,18948,0,75644,905343,1.895,0.0,7.564,90.534,75644,
bbmerge,gen_n1000000_l142_merged.fq,1000000,142,999939,980957,18982,0,78173,902784,1.898,0.0,7.817,90.278,78173,
bbmerge,gen_n1000000_l143_merged.fq,1000000,143,999923,980773,19150,0,79992,900781,1.915,0.0,7.999,90.078,79992,
bbmerge,gen_n1000000_l144_merged.fq,1000000,144,999931,980583,19348,0,82106,898477,1.935,0.0,8.211,89.848,82106,
bbmerge,gen_n1000000_l145_merged.fq,1000000,145,999928,982115,17813,0,84763,897352,1.781,0.0,8.476,89.735,84763,
bbmerge,gen_n1000000_l146_merged.fq,1000000,146,999929,980498,19431,0,86295,894203,1.943,0.0,8.63,89.42,86295,
bbmerge,gen_n1000000_l147_merged.fq,1000000,147,999921,980733,19188,0,89008,891725,1.919,0.0,8.901,89.172,89008,
bbmerge,gen_n1000000_l148_merged.fq,1000000,148,999912,980811,19101,0,90996,889815,1.91,0.0,9.1,88.981,90996,
bbmerge,gen_n1000000_l149_merged.fq,1000000,149,999919,980301,19618,0,92526,887775,1.962,0.0,9.253,88.778,92526,
bbmerge,gen_n1000000_l14_merged.fq,1000000,14,999918,900148,99770,0,7,900141,9.977,0.0,0.001,90.014,7,
bbmerge,gen_n1000000_l150_merged.fq,1000000,150,999914,981132,18782,0,95120,886012,1.878,0.0,9.512,88.601,95120,
bbmerge,gen_n1000000_l151_merged.fq,1000000,151,999923,980719,19204,0,97024,883695,1.92,0.0,9.702,88.37,97024,
bbmerge,gen_n1000000_l152_merged.fq,1000000,152,999920,980150,19770,0,98874,881276,1.977,0.0,9.887,88.128,98874,
bbmerge,gen_n1000000_l153_merged.fq,1000000,153,999914,979177,20737,0,101617,877560,2.074,0.0,10.162,87.756,101617,
bbmerge,gen_n1000000_l154_merged.fq,1000000,154,999923,978945,20978,0,103243,875702,2.098,0.0,10.324,87.57,103243,
bbmerge,gen_n1000000_l155_merged.fq,1000000,155,999916,980306,19610,0,106049,874257,1.961,0.0,10.605,87.426,106049,
bbmerge,gen_n1000000_l156_merged.fq,1000000,156,999920,978663,21257,0,107405,871258,2.126,0.0,10.741,87.126,107405,
bbmerge,gen_n1000000_l157_merged.fq,1000000,157,999892,978736,21156,0,109314,869422,2.116,0.0,10.931,86.942,109314,
bbmerge,gen_n1000000_l158_merged.fq,1000000,158,999933,978492,21441,0,111598,866894,2.144,0.0,11.16,86.689,111598,
bbmerge,gen_n1000000_l159_merged.fq,1000000,159,999910,977666,22244,0,113036,864630,2.224,0.0,11.304,86.463,113036,
bbmerge,gen_n1000000_l15_merged.fq,1000000,15,999906,905600,94306,0,10,905590,9.431,0.0,0.001,90.559,10,
bbmerge,gen_n1000000_l160_merged.fq,1000000,160,999911,978995,20916,0,115586,863409,2.092,0.0,11.559,86.341,115586,
bbmerge,gen_n1000000_l161_merged.fq,1000000,161,999908,978714,21194,0,117698,861016,2.119,0.0,11.77,86.102,117698,
bbmerge,gen_n1000000_l162_merged.fq,1000000,162,999910,978468,21442,0,119532,858936,2.144,0.0,11.953,85.894,119532,
bbmerge,gen_n1000000_l163_merged.fq,1000000,163,999933,978067,21866,0,121556,856511,2.187,0.0,12.156,85.651,121556,
bbmerge,gen_n1000000_l164_merged.fq,1000000,164,999915,977814,22101,0,123534,854280,2.21,0.0,12.353,85.428,123534,
bbmerge,gen_n1000000_l165_merged.fq,1000000,165,999917,978789,21128,0,125803,852986,2.113,0.0,12.58,85.299,125803,
bbmerge,gen_n1000000_l166_merged.fq,1000000,166,999915,977330,22585,0,127893,849437,2.259,0.0,12.789,84.944,127893,
bbmerge,gen_n1000000_l167_merged.fq,1000000,167,999913,977485,22428,0,130514,846971,2.243,0.0,13.051,84.697,130514,
bbmerge,gen_n1000000_l168_merged.fq,1000000,168,999917,977032,22885,0,132204,844828,2.288,0.0,13.22,84.483,132204,
bbmerge,gen_n1000000_l169_merged.fq,1000000,169,999922,976032,23890,0,133923,842109,2.389,0.0,13.392,84.211,133923,
bbmerge,gen_n1000000_l16_merged.fq,1000000,16,999917,904839,95078,0,6,904833,9.508,0.0,0.001,90.483,6,
bbmerge,gen_n1000000_l170_merged.fq,1000000,170,999923,977383,22540,0,136476,840907,2.254,0.0,13.648,84.091,136476,
bbmerge,gen_n1000000_l171_merged.fq,1000000,171,999914,976270,23644,0,138457,837813,2.364,0.0,13.846,83.781,138457,
bbmerge,gen_n1000000_l172_merged.fq,1000000,172,999922,975658,24264,0,141013,834645,2.426,0.0,14.101,83.465,141013,
bbmerge,gen_n1000000_l173_merged.fq,1000000,173,999927,975374,24553,0,142902,832472,2.455,0.0,14.29,83.247,142902,
bbmerge,gen_n1000000_l174_merged.fq,1000000,174,999914,974109,25805,0,144265,829844,2.581,0.0,14.427,82.984,144265,
bbmerge,gen_n1000000_l175_merged.fq,1000000,175,999925,974061,25864,0,146300,827761,2.586,0.0,14.63,82.776,146300,
bbmerge,gen_n1000000_l176_merged.fq,1000000,176,999930,970860,29070,0,148235,822625,2.907,0.0,14.824,82.263,148235,
bbmerge,gen_n1000000_l177_merged.fq,1000000,177,999920,969362,30558,0,150079,819283,3.056,0.0,15.008,81.928,150079,
bbmerge,gen_n1000000_l178_merged.fq,1000000,178,999916,969869,30047,0,152344,817525,3.005,0.0,15.234,81.752,152344,
bbmerge,gen_n1000000_l179_merged.fq,1000000,179,999920,970005,29915,0,154596,815409,2.992,0.0,15.46,81.541,154596,
bbmerge,gen_n1000000_l17_merged.fq,1000000,17,999905,930043,69862,0,99,929944,6.986,0.0,0.01,92.994,99,
bbmerge,gen_n1000000_l180_merged.fq,1000000,180,999915,971117,28798,0,156619,814498,2.88,0.0,15.662,81.45,156619,
bbmerge,gen_n1000000_l181_merged.fq,1000000,181,999924,970672,29252,0,159095,811577,2.925,0.0,15.909,81.158,159095,
bbmerge,gen_n1000000_l182_merged.fq,1000000,182,999910,970761,29149,0,160987,809774,2.915,0.0,16.099,80.977,160987,
bbmerge,gen_n1000000_l183_merged.fq,1000000,183,999924,970124,29800,0,162594,807530,2.98,0.0,16.259,80.753,162594,
bbmerge,gen_n1000000_l184_merged.fq,1000000,184,999926,969447,30479,0,165046,804401,3.048,0.0,16.505,80.44,165046,
bbmerge,gen_n1000000_l185_merged.fq,1000000,185,999927,970096,29831,0,167550,802546,2.983,0.0,16.755,80.255,167550,
bbmerge,gen_n1000000_l186_merged.fq,1000000,186,999915,969798,30117,0,169894,799904,3.012,0.0,16.989,79.99,169894,
bbmerge,gen_n1000000_l187_merged.fq,1000000,187,999925,969825,30100,0,171902,797923,3.01,0.0,17.19,79.792,171902,
bbmerge,gen_n1000000_l188_merged.fq,1000000,188,999917,969015,30902,0,173782,795233,3.09,0.0,17.378,79.523,173782,
bbmerge,gen_n1000000_l189_merged.fq,1000000,189,999930,968558,31372,0,175364,793194,3.137,0.0,17.536,79.319,175364,
bbmerge,gen_n1000000_l18_merged.fq,1000000,18,999914,930439,69475,0,155,930284,6.947,0.0,0.015,93.028,155,
bbmerge,gen_n1000000_l190_merged.fq,1000000,190,999924,968557,31367,0,178212,790345,3.137,0.0,17.821,79.034,178212,
bbmerge,gen_n1000000_l191_merged.fq,1000000,191,999921,966353,33568,0,179853,786500,3.357,0.0,17.985,78.65,179853,
bbmerge,gen_n1000000_l192_merged.fq,1000000,192,999907,966005,33902,0,183214,782791,3.39,0.0,18.321,78.279,183214,
bbmerge,gen_n1000000_l193_merged.fq,1000000,193,999920,966257,33663,0,184266,781991,3.366,0.0,18.427,78.199,184266,
bbmerge,gen_n1000000_l194_merged.fq,1000000,194,999925,965287,34638,0,185643,779644,3.464,0.0,18.564,77.964,185643,
bbmerge,gen_n1000000_l195_merged.fq,1000000,195,999921,965474,34447,0,188955,776519,3.445,0.0,18.896,77.652,188955,
bbmerge,gen_n1000000_l196_merged.fq,1000000,196,999940,965140,34800,0,191840,773300,3.48,0.0,19.184,77.33,191840,
bbmerge,gen_n1000000_l197_merged.fq,1000000,197,999919,964636,35283,0,194110,770526,3.528,0.0,19.411,77.053,194110,
bbmerge,gen_n1000000_l198_merged.fq,1000000,198,999913,963643,36270,0,195835,767808,3.627,0.0,19.584,76.781,195835,
bbmerge,gen_n1000000_l199_merged.fq,1000000,199,999921,962530,37391,0,198637,763893,3.739,0.0,19.864,76.389,198637,
bbmerge,gen_n1000000_l19_merged.fq,1000000,19,999898,928351,71547,0,214,928137,7.155,0.0,0.021,92.814,214,
bbmerge,gen_n1000000_l1_merged.fq,1000000,1,999924,0,999924,0,0,0,99.992,0.0,0.0,0.0,0,
bbmerge,gen_n1000000_l200_merged.fq,1000000,200,999912,963046,36866,0,200667,762379,3.687,0.0,20.067,76.238,200667,
bbmerge,gen_n1000000_l201_merged.fq,1000000,201,999934,961753,38181,0,202837,758916,3.818,0.0,20.284,75.892,202837,
bbmerge,gen_n1000000_l202_merged.fq,1000000,202,999919,960495,39424,0,205277,755218,3.942,0.0,20.528,75.522,205277,
bbmerge,gen_n1000000_l203_merged.fq,1000000,203,999910,960867,39043,0,207926,752941,3.904,0.0,20.793,75.294,207926,
bbmerge,gen_n1000000_l204_merged.fq,1000000,204,999907,959662,40245,0,210160,749502,4.025,0.0,21.016,74.95,210160,
bbmerge,gen_n1000000_l205_merged.fq,1000000,205,999929,960137,39792,0,213101,747036,3.979,0.0,21.31,74.704,213101,
bbmerge,gen_n1000000_l206_merged.fq,1000000,206,999928,955319,44609,0,213585,741734,4.461,0.0,21.358,74.173,213585,
bbmerge,gen_n1000000_l207_merged.fq,1000000,207,999924,954156,45768,0,215680,738476,4.577,0.0,21.568,73.848,215680,
bbmerge,gen_n1000000_l208_merged.fq,1000000,208,999926,952980,46946,0,218553,734427,4.695,0.0,21.855,73.443,218553,
bbmerge,gen_n1000000_l209_merged.fq,1000000,209,999910,952809,47101,0,221597,731212,4.71,0.0,22.16,73.121,221597,
bbmerge,gen_n1000000_l20_merged.fq,1000000,20,999917,927380,72537,0,291,927089,7.254,0.0,0.029,92.709,291,
bbmerge,gen_n1000000_l210_merged.fq,1000000,210,999916,952739,47177,0,223299,729440,4.718,0.0,22.33,72.944,223299,
bbmerge,gen_n1000000_l211_merged.fq,1000000,211,999931,950551,49380,0,225999,724552,4.938,0.0,22.6,72.455,225999,
bbmerge,gen_n1000000_l212_merged.fq,1000000,212,999910,949173,50737,0,227931,721242,5.074,0.0,22.793,72.124,227931,
bbmerge,gen_n1000000_l213_merged.fq,1000000,213,999900,948292,51608,0,229252,719040,5.161,0.0,22.925,71.904,229252,
bbmerge,gen_n1000000_l214_merged.fq,1000000,214,999937,947135,52802,0,232306,714829,5.28,0.0,23.231,71.483,232306,
bbmerge,gen_n1000000_l215_merged.fq,1000000,215,999920,946549,53371,0,235080,711469,5.337,0.0,23.508,71.147,235080,
bbmerge,gen_n1000000_l216_merged.fq,1000000,216,999907,944383,55524,0,236339,708044,5.552,0.0,23.634,70.804,236339,
bbmerge,gen_n1000000_l217_merged.fq,1000000,217,999922,941800,58122,0,239349,702451,5.812,0.0,23.935,70.245,239349,
bbmerge,gen_n1000000_l218_merged.fq,1000000,218,999919,939619,60300,0,241712,697907,6.03,0.0,24.171,69.791,241712,
bbmerge,gen_n1000000_l219_merged.fq,1000000,219,999918,939245,60673,0,243709,695536,6.067,0.0,24.371,69.554,243709,
bbmerge,gen_n1000000_l21_merged.fq,1000000,21,999934,928516,71418,0,406,928110,7.142,0.0,0.041,92.811,406,
bbmerge,gen_n1000000_l220_merged.fq,1000000,220,999916,937034,62882,0,245525,691509,6.288,0.0,24.552,69.151,245525,
bbmerge,gen_n1000000_l221_merged.fq,1000000,221,999924,928668,71256,0,246184,682484,7.126,0.0,24.618,68.248,246184,
bbmerge,gen_n1000000_l222_merged.fq,1000000,222,999924,928584,71340,0,248860,679724,7.134,0.0,24.886,67.972,248860,
bbmerge,gen_n1000000_l223_merged.fq,1000000,223,999932,919815,80117,0,249606,670209,8.012,0.0,24.961,67.021,249606,
bbmerge,gen_n1000000_l224_merged.fq,1000000,224,999922,916755,83167,0,250239,666516,8.317,0.0,25.024,66.652,250239,
bbmerge,gen_n1000000_l225_merged.fq,1000000,225,999911,914394,85517,0,253857,660537,8.552,0.0,25.386,66.054,253857,
bbmerge,gen_n1000000_l226_merged.fq,1000000,226,999920,913478,86442,0,255730,657748,8.644,0.0,25.573,65.775,255730,
bbmerge,gen_n1000000_l227_merged.fq,1000000,227,999921,908430,91491,0,256339,652091,9.149,0.0,25.634,65.209,256339,
bbmerge,gen_n1000000_l228_merged.fq,1000000,228,999925,906142,93783,0,260098,646044,9.378,0.0,26.01,64.604,260098,
bbmerge,gen_n1000000_l229_merged.fq,1000000,229,999915,893147,106768,0,258157,634990,10.677,0.0,25.816,63.499,258157,
bbmerge,gen_n1000000_l22_merged.fq,1000000,22,999918,935353,64565,0,527,934826,6.457,0.0,0.053,93.483,527,
bbmerge,gen_n1000000_l230_merged.fq,1000000,230,999909,888214,111695,0,259103,629111,11.17,0.0,25.91,62.911,259103,
bbmerge,gen_n1000000_l231_merged.fq,1000000,231,999908,884693,115215,0,261414,623279,11.521,0.0,26.141,62.328,261414,
bbmerge,gen_n1000000_l232_merged.fq,1000000,232,999927,877236,122691,0,261654,615582,12.269,0.0,26.165,61.558,261654,
bbmerge,gen_n1000000_l233_merged.fq,1000000,233,999907,868741,131166,0,261733,607008,13.117,0.0,26.173,60.701,261733,
bbmerge,gen_n1000000_l234_merged.fq,1000000,234,999922,836696,163226,0,254743,581953,16.323,0.0,25.474,58.195,254743,
bbmerge,gen_n1000000_l235_merged.fq,1000000,235,999915,830323,169592,0,254785,575538,16.959,0.0,25.478,57.554,254785,
bbmerge,gen_n1000000_l236_merged.fq,1000000,236,999917,817653,182264,1,254415,563237,18.226,0.0,25.442,56.324,254416,
bbmerge,gen_n1000000_l237_merged.fq,1000000,237,999921,799142,200779,1,251261,547880,20.078,0.0,25.126,54.788,251262,
bbmerge,gen_n1000000_l238_merged.fq,1000000,238,999925,756305,243620,2,239952,516351,24.362,0.0,23.995,51.635,239954,
bbmerge,gen_n1000000_l239_merged.fq,1000000,239,999926,679808,320118,2,217990,461816,32.012,0.0,21.799,46.182,217992,
bbmerge,gen_n1000000_l23_merged.fq,1000000,23,999913,934831,65082,0,604,934227,6.508,0.0,0.06,93.423,604,
bbmerge,gen_n1000000_l240_merged.fq,1000000,240,999921,415880,584041,0,135211,280669,58.404,0.0,13.521,28.067,135211,
bbmerge,gen_n1000000_l241_merged.fq,1000000,241,999922,212242,787680,1,69503,142738,78.768,0.0,6.95,14.274,69504,
bbmerge,gen_n1000000_l242_merged.fq,1000000,242,999910,2,999908,2,0,0,99.991,0.0,0.0,0.0,2,
bbmerge,gen_n1000000_l243_merged.fq,1000000,243,999926,0,999926,0,0,0,99.993,0.0,0.0,0.0,0,
bbmerge,gen_n1000000_l244_merged.fq,1000000,244,999921,1,999920,1,0,0,99.992,0.0,0.0,0.0,1,
bbmerge,gen_n1000000_l245_merged.fq,1000000,245,999908,155,999753,155,0,0,99.975,0.015,0.0,0.0,155,
bbmerge,gen_n1000000_l246_merged.fq,1000000,246,999926,220,999706,220,0,0,99.971,0.022,0.0,0.0,220,
bbmerge,gen_n1000000_l247_merged.fq,1000000,247,999918,246,999672,246,0,0,99.967,0.025,0.0,0.0,246,
bbmerge,gen_n1000000_l248_merged.fq,1000000,248,999911,293,999618,293,0,0,99.962,0.029,0.0,0.0,293,
bbmerge,gen_n1000000_l249_merged.fq,1000000,249,999912,298,999614,298,0,0,99.961,0.03,0.0,0.0,298,
bbmerge,gen_n1000000_l24_merged.fq,1000000,24,999929,935489,64440,0,760,934729,6.444,0.0,0.076,93.473,760,
bbmerge,gen_n1000000_l250_merged.fq,1000000,250,999916,297,999619,297,0,0,99.962,0.03,0.0,0.0,297,
bbmerge,gen_n1000000_l25_merged.fq,1000000,25,999922,934046,65876,0,905,933141,6.588,0.0,0.09,93.314,905,
bbmerge,gen_n1000000_l26_merged.fq,1000000,26,999912,933706,66206,0,1013,932693,6.621,0.0,0.101,93.269,1013,
bbmerge,gen_n1000000_l27_merged.fq,1000000,27,999930,933545,66385,0,1247,932298,6.638,0.0,0.125,93.23,1247,
bbmerge,gen_n1000000_l28_merged.fq,1000000,28,999922,937287,62635,0,1413,935874,6.263,0.0,0.141,93.587,1413,
bbmerge,gen_n1000000_l29_merged.fq,1000000,29,999909,936640,63269,0,1597,935043,6.327,0.0,0.16,93.504,1597,
bbmerge,gen_n1000000_l2_merged.fq,1000000,2,999928,0,999928,0,0,0,99.993,0.0,0.0,0.0,0,
bbmerge,gen_n1000000_l30_merged.fq,1000000,30,999937,938687,61250,0,1880,936807,6.125,0.0,0.188,93.681,1880,
bbmerge,gen_n1000000_l31_merged.fq,1000000,31,999928,937395,62533,0,2201,935194,6.253,0.0,0.22,93.519,2201,
bbmerge,gen_n1000000_l32_merged.fq,1000000,32,999921,937602,62319,0,2358,935244,6.232,0.0,0.236,93.524,2358,
bbmerge,gen_n1000000_l33_merged.fq,1000000,33,999929,939283,60646,0,2626,936657,6.065,0.0,0.263,93.666,2626,
bbmerge,gen_n1000000_l34_merged.fq,1000000,34,999934,939862,60072,0,2846,937016,6.007,0.0,0.285,93.702,2846,
bbmerge,gen_n1000000_l35_merged.fq,1000000,35,999903,940738,59165,0,3231,937507,5.917,0.0,0.323,93.751,3231,
bbmerge,gen_n1000000_l36_merged.fq,1000000,36,999918,939950,59968,0,3447,936503,5.997,0.0,0.345,93.65,3447,
bbmerge,gen_n1000000_l37_merged.fq,1000000,37,999921,941628,58293,0,3726,937902,5.829,0.0,0.373,93.79,3726,
bbmerge,gen_n1000000_l38_merged.fq,1000000,38,999917,942260,57657,0,4204,938056,5.766,0.0,0.42,93.806,4204,
bbmerge,gen_n1000000_l39_merged.fq,1000000,39,999919,943301,56618,0,4522,938779,5.662,0.0,0.452,93.878,4522,
bbmerge,gen_n1000000_l3_merged.fq,1000000,3,999926,0,999926,0,0,0,99.993,0.0,0.0,0.0,0,
bbmerge,gen_n1000000_l40_merged.fq,1000000,40,999920,944935,54985,0,4703,940232,5.498,0.0,0.47,94.023,4703,
bbmerge,gen_n1000000_l41_merged.fq,1000000,41,999900,944149,55751,0,5206,938943,5.575,0.0,0.521,93.894,5206,
bbmerge,gen_n1000000_l42_merged.fq,1000000,42,999906,945070,54836,0,5494,939576,5.484,0.0,0.549,93.958,5494,
bbmerge,gen_n1000000_l43_merged.fq,1000000,43,999921,946085,53836,0,5820,940265,5.384,0.0,0.582,94.026,5820,
bbmerge,gen_n1000000_l44_merged.fq,1000000,44,999910,948181,51729,0,6220,941961,5.173,0.0,0.622,94.196,6220,
bbmerge,gen_n1000000_l45_merged.fq,1000000,45,999912,950346,49566,0,6790,943556,4.957,0.0,0.679,94.356,6790,
bbmerge,gen_n1000000_l46_merged.fq,1000000,46,999923,950533,49390,0,7119,943414,4.939,0.0,0.712,94.341,7119,
bbmerge,gen_n1000000_l47_merged.fq,1000000,47,999928,952335,47593,0,7564,944771,4.759,0.0,0.756,94.477,7564,
bbmerge,gen_n1000000_l48_merged.fq,1000000,48,999923,952170,47753,0,8048,944122,4.775,0.0,0.805,94.412,8048,
bbmerge,gen_n1000000_l49_merged.fq,1000000,49,999925,954172,45753,0,8354,945818,4.575,0.0,0.835,94.582,8354,
bbmerge,gen_n1000000_l4_merged.fq,1000000,4,999896,0,999896,0,0,0,99.99,0.0,0.0,0.0,0,
bbmerge,gen_n1000000_l50_merged.fq,1000000,50,999927,955429,44498,0,8919,946510,4.45,0.0,0.892,94.651,8919,
bbmerge,gen_n1000000_l51_merged.fq,1000000,51,999919,956315,43604,0,9238,947077,4.36,0.0,0.924,94.708,9238,
bbmerge,gen_n1000000_l52_merged.fq,1000000,52,999920,957282,42638,0,9911,947371,4.264,0.0,0.991,94.737,9911,
bbmerge,gen_n1000000_l53_merged.fq,1000000,53,999912,958604,41308,0,9960,948644,4.131,0.0,0.996,94.864,9960,
bbmerge,gen_n1000000_l54_merged.fq,1000000,54,999922,959792,40130,0,10510,949282,4.013,0.0,1.051,94.928,10510,
bbmerge,gen_n1000000_l55_merged.fq,1000000,55,999914,960288,39626,0,10908,949380,3.963,0.0,1.091,94.938,10908,
bbmerge,gen_n1000000_l56_merged.fq,1000000,56,999916,959550,40366,0,11481,948069,4.037,0.0,1.148,94.807,11481,
bbmerge,gen_n1000000_l57_merged.fq,1000000,57,999900,962094,37806,0,11821,950273,3.781,0.0,1.182,95.027,11821,
bbmerge,gen_n1000000_l58_merged.fq,1000000,58,999915,962421,37494,0,12295,950126,3.749,0.0,1.23,95.013,12295,
bbmerge,gen_n1000000_l59_merged.fq,1000000,59,999905,964003,35902,0,12717,951286,3.59,0.0,1.272,95.129,12717,
bbmerge,gen_n1000000_l5_merged.fq,1000000,5,999925,0,999925,0,0,0,99.992,0.0,0.0,0.0,0,
bbmerge,gen_n1000000_l60_merged.fq,1000000,60,999917,965900,34017,0,13213,952687,3.402,0.0,1.321,95.269,13213,
bbmerge,gen_n1000000_l61_merged.fq,1000000,61,999918,965980,33938,0,13447,952533,3.394,0.0,1.345,95.253,13447,
bbmerge,gen_n1000000_l62_merged.fq,1000000,62,999910,967700,32210,0,13833,953867,3.221,0.0,1.383,95.387,13833,
bbmerge,gen_n1000000_l63_merged.fq,1000000,63,999911,968677,31234,0,14294,954383,3.123,0.0,1.429,95.438,14294,
bbmerge,gen_n1000000_l64_merged.fq,1000000,64,999922,969919,30003,0,15086,954833,3.0,0.0,1.509,95.483,15086,
bbmerge,gen_n1000000_l65_merged.fq,1000000,65,999920,971150,28770,0,15337,955813,2.877,0.0,1.534,95.581,15337,
bbmerge,gen_n1000000_l66_merged.fq,1000000,66,999904,970053,29851,0,15771,954282,2.985,0.0,1.577,95.428,15771,
bbmerge,gen_n1000000_l67_merged.fq,1000000,67,999925,971460,28465,0,16155,955305,2.847,0.0,1.615,95.53,16155,
bbmerge,gen_n1000000_l68_merged.fq,1000000,68,999915,972374,27541,0,16663,955711,2.754,0.0,1.666,95.571,16663,
bbmerge,gen_n1000000_l69_merged.fq,1000000,69,999916,973444,26472,0,16891,956553,2.647,0.0,1.689,95.655,16891,
bbmerge,gen_n1000000_l6_merged.fq,1000000,6,999916,0,999916,0,0,0,99.992,0.0,0.0,0.0,0,
bbmerge,gen_n1000000_l70_merged.fq,1000000,70,999901,974366,25535,0,17422,956944,2.553,0.0,1.742,95.694,17422,
bbmerge,gen_n1000000_l71_merged.fq,1000000,71,999895,973239,26656,0,17800,955439,2.666,0.0,1.78,95.544,17800,
bbmerge,gen_n1000000_l72_merged.fq,1000000,72,999909,974213,25696,0,18517,955696,2.57,0.0,1.852,95.57,18517,
bbmerge,gen_n1000000_l73_merged.fq,1000000,73,999926,974928,24998,0,18753,956175,2.5,0.0,1.875,95.618,18753,
bbmerge,gen_n1000000_l74_merged.fq,1000000,74,999914,975552,24362,0,19327,956225,2.436,0.0,1.933,95.623,19327,
bbmerge,gen_n1000000_l75_merged.fq,1000000,75,999929,976570,23359,0,19546,957024,2.336,0.0,1.955,95.702,19546,
bbmerge,gen_n1000000_l76_merged.fq,1000000,76,999914,975787,24127,0,19983,955804,2.413,0.0,1.998,95.58,19983,
bbmerge,gen_n1000000_l77_merged.fq,1000000,77,999902,976666,23236,0,20469,956197,2.324,0.0,2.047,95.62,20469,
bbmerge,gen_n1000000_l78_merged.fq,1000000,78,999918,977024,22894,0,21069,955955,2.289,0.0,2.107,95.596,21069,
bbmerge,gen_n1000000_l79_merged.fq,1000000,79,999921,977781,22140,0,21044,956737,2.214,0.0,2.104,95.674,21044,
bbmerge,gen_n1000000_l7_merged.fq,1000000,7,999912,0,999912,0,0,0,99.991,0.0,0.0,0.0,0,
bbmerge,gen_n1000000_l80_merged.fq,1000000,80,999907,978245,21662,0,21390,956855,2.166,0.0,2.139,95.686,21390,
bbmerge,gen_n1000000_l81_merged.fq,1000000,81,999923,976636,23287,0,21888,954748,2.329,0.0,2.189,95.475,21888,
bbmerge,gen_n1000000_l82_merged.fq,1000000,82,999924,977587,22337,0,22353,955234,2.234,0.0,2.235,95.523,22353,
bbmerge,gen_n1000000_l83_merged.fq,1000000,83,999923,978783,21140,0,22467,956316,2.114,0.0,2.247,95.632,22467,
bbmerge,gen_n1000000_l84_merged.fq,1000000,84,999906,980691,19215,0,22907,957784,1.921,0.0,2.291,95.778,22907,
bbmerge,gen_n1000000_l85_merged.fq,1000000,85,999916,981218,18698,0,23725,957493,1.87,0.0,2.373,95.749,23725,
bbmerge,gen_n1000000_l86_merged.fq,1000000,86,999921,978665,21256,0,23980,954685,2.126,0.0,2.398,95.469,23980,
bbmerge,gen_n1000000_l87_merged.fq,1000000,87,999935,979576,20359,0,24442,955134,2.036,0.0,2.444,95.513,24442,
bbmerge,gen_n1000000_l88_merged.fq,1000000,88,999924,980440,19484,0,24626,955814,1.948,0.0,2.463,95.581,24626,
bbmerge,gen_n1000000_l89_merged.fq,1000000,89,999911,981426,18485,0,24686,956740,1.849,0.0,2.469,95.674,24686,
bbmerge,gen_n1000000_l8_merged.fq,1000000,8,999921,0,999921,0,0,0,99.992,0.0,0.0,0.0,0,
bbmerge,gen_n1000000_l90_merged.fq,1000000,90,999923,981553,18370,0,25160,956393,1.837,0.0,2.516,95.639,25160,
bbmerge,gen_n1000000_l91_merged.fq,1000000,91,999915,979227,20688,0,25677,953550,2.069,0.0,2.568,95.355,25677,
bbmerge,gen_n1000000_l92_merged.fq,1000000,92,999916,980547,19369,0,26072,954475,1.937,0.0,2.607,95.447,26072,
bbmerge,gen_n1000000_l93_merged.fq,1000000,93,999908,982216,17692,0,26632,955584,1.769,0.0,2.663,95.558,26632,
bbmerge,gen_n1000000_l94_merged.fq,1000000,94,999916,983500,16416,0,26908,956592,1.642,0.0,2.691,95.659,26908,
bbmerge,gen_n1000000_l95_merged.fq,1000000,95,999918,983737,16181,0,27551,956186,1.618,0.0,2.755,95.619,27551,
bbmerge,gen_n1000000_l96_merged.fq,1000000,96,999915,981842,18073,0,27769,954073,1.807,0.0,2.777,95.407,27769,
bbmerge,gen_n1000000_l97_merged.fq,1000000,97,999915,982906,17009,0,28267,954639,1.701,0.0,2.827,95.464,28267,
bbmerge,gen_n1000000_l98_merged.fq,1000000,98,999919,983643,16276,0,28640,955003,1.628,0.0,2.864,95.5,28640,
bbmerge,gen_n1000000_l99_merged.fq,1000000,99,999915,985735,14180,0,29233,956502,1.418,0.0,2.923,95.65,29233,
bbmerge,gen_n1000000_l9_merged.fq,1000000,9,999911,0,999911,0,0,0,99.991,0.0,0.0,0.0,0,
