program,filename,nfrags,fraglen,total_sequences,total_reads,dropped_reads,incorrect_length,correct_len_incorrect_seq,perfectly_reconstructed,dropped_reads_percentage,incorrect_length_percentage,correct_len_incorrect_seq_percentage,perfectly_reconstructed_percentage,divergent_reads,
leeHom,gen_n1000000_l1000_merged.fq.gz,1000000,1000,999921,14580,985341,14580,0,0,98.534,1.458,0.0,0.0,14580,
leeHom,gen_n1000000_l100_merged.fq.gz,1000000,100,999928,1000000,-72,0,22212,977788,-0.007,0.0,2.221,97.779,22212,
leeHom,gen_n1000000_l101_merged.fq.gz,1000000,101,999921,1000000,-79,0,22140,977860,-0.008,0.0,2.214,97.786,22140,
leeHom,gen_n1000000_l102_merged.fq.gz,1000000,102,999926,1000000,-74,0,22588,977412,-0.007,0.0,2.259,97.741,22588,
leeHom,gen_n1000000_l103_merged.fq.gz,1000000,103,999915,1000000,-85,0,22578,977422,-0.009,0.0,2.258,97.742,22578,
leeHom,gen_n1000000_l104_merged.fq.gz,1000000,104,999911,1000000,-89,0,22906,977094,-0.009,0.0,2.291,97.709,22906,
leeHom,gen_n1000000_l105_merged.fq.gz,1000000,105,999920,1000000,-80,0,23210,976790,-0.008,0.0,2.321,97.679,23210,
leeHom,gen_n1000000_l106_merged.fq.gz,1000000,106,999938,1000000,-62,0,23231,976769,-0.006,0.0,2.323,97.677,23231,
leeHom,gen_n1000000_l107_merged.fq.gz,1000000,107,999913,1000000,-87,0,24112,975888,-0.009,0.0,2.411,97.589,24112,
leeHom,gen_n1000000_l108_merged.fq.gz,1000000,108,999922,999999,-77,0,23971,976028,-0.008,0.0,2.397,97.603,23971,
leeHom,gen_n1000000_l109_merged.fq.gz,1000000,109,999923,1000000,-77,0,24220,975780,-0.008,0.0,2.422,97.578,24220,
leeHom,gen_n1000000_l10_merged.fq.gz,1000000,10,999901,1000000,-99,0,2404,997596,-0.01,0.0,0.24,99.76,2404,
leeHom,gen_n1000000_l110_merged.fq.gz,1000000,110,999916,1000000,-84,0,24520,975480,-0.008,0.0,2.452,97.548,24520,
leeHom,gen_n1000000_l111_merged.fq.gz,1000000,111,999908,1000000,-92,0,24707,975293,-0.009,0.0,2.471,97.529,24707,
leeHom,gen_n1000000_l112_merged.fq.gz,1000000,112,999924,1000000,-76,0,24868,975132,-0.008,0.0,2.487,97.513,24868,
leeHom,gen_n1000000_l113_merged.fq.gz,1000000,113,999914,1000000,-86,0,25027,974973,-0.009,0.0,2.503,97.497,25027,
leeHom,gen_n1000000_l114_merged.fq.gz,1000000,114,999932,1000000,-68,0,25721,974279,-0.007,0.0,2.572,97.428,25721,
leeHom,gen_n1000000_l115_merged.fq.gz,1000000,115,999935,1000000,-65,0,26010,973990,-0.006,0.0,2.601,97.399,26010,
leeHom,gen_n1000000_l116_merged.fq.gz,1000000,116,999926,1000000,-74,0,25959,974041,-0.007,0.0,2.596,97.404,25959,
leeHom,gen_n1000000_l117_merged.fq.gz,1000000,117,999917,1000000,-83,0,26408,973592,-0.008,0.0,2.641,97.359,26408,
leeHom,gen_n1000000_l118_merged.fq.gz,1000000,118,999936,1000000,-64,0,26753,973247,-0.006,0.0,2.675,97.325,26753,
leeHom,gen_n1000000_l119_merged.fq.gz,1000000,119,999928,999999,-71,0,26991,973008,-0.007,0.0,2.699,97.301,26991,
leeHom,gen_n1000000_l11_merged.fq.gz,1000000,11,999928,1000000,-72,0,2470,997530,-0.007,0.0,0.247,99.753,2470,
leeHom,gen_n1000000_l120_merged.fq.gz,1000000,120,999913,1000000,-87,0,27357,972643,-0.009,0.0,2.736,97.264,27357,
leeHom,gen_n1000000_l121_merged.fq.gz,1000000,121,999915,1000000,-85,0,27268,972732,-0.009,0.0,2.727,97.273,27268,
leeHom,gen_n1000000_l122_merged.fq.gz,1000000,122,999926,999999,-73,0,27746,972253,-0.007,0.0,2.775,97.225,27746,
leeHom,gen_n1000000_l123_merged.fq.gz,1000000,123,999926,1000000,-74,0,28080,971920,-0.007,0.0,2.808,97.192,28080,
leeHom,gen_n1000000_l124_merged.fq.gz,1000000,124,999907,1000000,-93,0,28523,971477,-0.009,0.0,2.852,97.148,28523,
leeHom,gen_n1000000_l125_merged.fq.gz,1000000,125,999938,1000000,-62,0,28511,971489,-0.006,0.0,2.851,97.149,28511,
leeHom,gen_n1000000_l126_merged.fq.gz,1000000,126,999918,1000000,-82,0,31221,968779,-0.008,0.0,3.122,96.878,31221,
leeHom,gen_n1000000_l127_merged.fq.gz,1000000,127,999911,1000000,-89,0,33341,966659,-0.009,0.0,3.334,96.666,33341,
leeHom,gen_n1000000_l128_merged.fq.gz,1000000,128,999924,1000000,-76,0,35575,964425,-0.008,0.0,3.558,96.442,35575,
leeHom,gen_n1000000_l129_merged.fq.gz,1000000,129,999908,999998,-90,1,38456,961541,-0.009,0.0,3.846,96.154,38457,
leeHom,gen_n1000000_l12_merged.fq.gz,1000000,12,999912,1000000,-88,0,2602,997398,-0.009,0.0,0.26,99.74,2602,
leeHom,gen_n1000000_l130_merged.fq.gz,1000000,130,999922,999992,-70,4,41442,958546,-0.007,0.0,4.144,95.855,41446,
leeHom,gen_n1000000_l131_merged.fq.gz,1000000,131,999914,999998,-84,16,44306,955676,-0.008,0.002,4.431,95.568,44322,
leeHom,gen_n1000000_l132_merged.fq.gz,1000000,132,999903,999998,-95,22,47367,952609,-0.009,0.002,4.737,95.261,47389,
leeHom,gen_n1000000_l133_merged.fq.gz,1000000,133,999924,1000000,-76,29,49565,950406,-0.008,0.003,4.957,95.041,49594,
leeHom,gen_n1000000_l134_merged.fq.gz,1000000,134,999910,999996,-86,18,51778,948200,-0.009,0.002,5.178,94.82,51796,
leeHom,gen_n1000000_l135_merged.fq.gz,1000000,135,999914,999998,-84,15,53764,946219,-0.008,0.002,5.376,94.622,53779,
leeHom,gen_n1000000_l136_merged.fq.gz,1000000,136,999919,999996,-77,14,56606,943376,-0.008,0.001,5.661,94.338,56620,
leeHom,gen_n1000000_l137_merged.fq.gz,1000000,137,999921,999997,-76,24,58437,941536,-0.008,0.002,5.844,94.154,58461,
leeHom,gen_n1000000_l138_merged.fq.gz,1000000,138,999916,999997,-81,13,60904,939080,-0.008,0.001,6.09,93.908,60917,
leeHom,gen_n1000000_l139_merged.fq.gz,1000000,139,999922,999995,-73,18,63614,936363,-0.007,0.002,6.361,93.636,63632,
leeHom,gen_n1000000_l13_merged.fq.gz,1000000,13,999925,1000000,-75,0,2830,997170,-0.007,0.0,0.283,99.717,2830,
leeHom,gen_n1000000_l140_merged.fq.gz,1000000,140,999928,999997,-69,18,65539,934440,-0.007,0.002,6.554,93.444,65557,
leeHom,gen_n1000000_l141_merged.fq.gz,1000000,141,999935,999996,-61,22,67441,932533,-0.006,0.002,6.744,93.253,67463,
leeHom,gen_n1000000_l142_merged.fq.gz,1000000,142,999939,999996,-57,12,70279,929705,-0.006,0.001,7.028,92.971,70291,
leeHom,gen_n1000000_l143_merged.fq.gz,1000000,143,999923,999997,-74,14,72285,927698,-0.007,0.001,7.229,92.77,72299,
leeHom,gen_n1000000_l144_merged.fq.gz,1000000,144,999931,999996,-65,25,74675,925296,-0.006,0.003,7.468,92.53,74700,
leeHom,gen_n1000000_l145_merged.fq.gz,1000000,145,999928,999997,-69,26,77383,922588,-0.007,0.003,7.738,92.259,77409,
leeHom,gen_n1000000_l146_merged.fq.gz,1000000,146,999929,999995,-66,32,79214,920749,-0.007,0.003,7.921,92.075,79246,
leeHom,gen_n1000000_l147_merged.fq.gz,1000000,147,999921,999989,-68,39,81944,918006,-0.007,0.004,8.194,91.801,81983,
leeHom,gen_n1000000_l148_merged.fq.gz,1000000,148,999912,999984,-72,27,84179,915778,-0.007,0.003,8.418,91.578,84206,
leeHom,gen_n1000000_l149_merged.fq.gz,1000000,149,999919,999979,-60,46,85980,913953,-0.006,0.005,8.598,91.395,86026,
leeHom,gen_n1000000_l14_merged.fq.gz,1000000,14,999918,1000000,-82,0,3119,996881,-0.008,0.0,0.312,99.688,3119,
leeHom,gen_n1000000_l150_merged.fq.gz,1000000,150,999914,999982,-68,73,88585,911324,-0.007,0.007,8.858,91.132,88658,
leeHom,gen_n1000000_l151_merged.fq.gz,1000000,151,999923,999978,-55,85,90754,909139,-0.006,0.009,9.075,90.914,90839,
leeHom,gen_n1000000_l152_merged.fq.gz,1000000,152,999920,999976,-56,91,92954,906931,-0.006,0.009,9.295,90.693,93045,
leeHom,gen_n1000000_l153_merged.fq.gz,1000000,153,999914,999984,-70,113,95821,904050,-0.007,0.011,9.582,90.405,95934,
leeHom,gen_n1000000_l154_merged.fq.gz,1000000,154,999923,999975,-52,125,97725,902125,-0.005,0.013,9.773,90.212,97850,
leeHom,gen_n1000000_l155_merged.fq.gz,1000000,155,999916,999977,-61,151,100519,899307,-0.006,0.015,10.052,89.931,100670,
leeHom,gen_n1000000_l156_merged.fq.gz,1000000,156,999920,999976,-56,165,102215,897596,-0.006,0.017,10.222,89.76,102380,
leeHom,gen_n1000000_l157_merged.fq.gz,1000000,157,999892,999981,-89,213,104505,895263,-0.009,0.021,10.45,89.526,104718,
leeHom,gen_n1000000_l158_merged.fq.gz,1000000,158,999933,999966,-33,219,106675,893072,-0.003,0.022,10.668,89.307,106894,
leeHom,gen_n1000000_l159_merged.fq.gz,1000000,159,999910,999964,-54,242,108553,891169,-0.005,0.024,10.855,89.117,108795,
leeHom,gen_n1000000_l15_merged.fq.gz,1000000,15,999906,1000000,-94,0,3251,996749,-0.009,0.0,0.325,99.675,3251,
leeHom,gen_n1000000_l160_merged.fq.gz,1000000,160,999911,999970,-59,258,111037,888675,-0.006,0.026,11.104,88.867,111295,
leeHom,gen_n1000000_l161_merged.fq.gz,1000000,161,999908,999970,-62,254,113474,886242,-0.006,0.025,11.347,88.624,113728,
leeHom,gen_n1000000_l162_merged.fq.gz,1000000,162,999910,999967,-57,319,115444,884204,-0.006,0.032,11.544,88.42,115763,
leeHom,gen_n1000000_l163_merged.fq.gz,1000000,163,999933,999964,-31,324,118021,881619,-0.003,0.032,11.802,88.162,118345,
leeHom,gen_n1000000_l164_merged.fq.gz,1000000,164,999915,999956,-41,306,119900,879750,-0.004,0.031,11.99,87.975,120206,
leeHom,gen_n1000000_l165_merged.fq.gz,1000000,165,999917,999960,-43,337,122185,877438,-0.004,0.034,12.219,87.744,122522,
leeHom,gen_n1000000_l166_merged.fq.gz,1000000,166,999915,999945,-30,338,124668,874939,-0.003,0.034,12.467,87.494,125006,
leeHom,gen_n1000000_l167_merged.fq.gz,1000000,167,999913,999950,-37,420,127243,872287,-0.004,0.042,12.724,87.229,127663,
leeHom,gen_n1000000_l168_merged.fq.gz,1000000,168,999917,999951,-34,382,129264,870305,-0.003,0.038,12.926,87.031,129646,
leeHom,gen_n1000000_l169_merged.fq.gz,1000000,169,999922,999943,-21,410,131323,868210,-0.002,0.041,13.132,86.821,131733,
leeHom,gen_n1000000_l16_merged.fq.gz,1000000,16,999917,1000000,-83,0,3510,996490,-0.008,0.0,0.351,99.649,3510,
leeHom,gen_n1000000_l170_merged.fq.gz,1000000,170,999923,999939,-16,462,133920,865557,-0.002,0.046,13.392,86.556,134382,
leeHom,gen_n1000000_l171_merged.fq.gz,1000000,171,999914,999938,-24,483,136174,863281,-0.002,0.048,13.617,86.328,136657,
leeHom,gen_n1000000_l172_merged.fq.gz,1000000,172,999922,999924,-2,508,138948,860468,-0.0,0.051,13.895,86.047,139456,
leeHom,gen_n1000000_l173_merged.fq.gz,1000000,173,999927,999936,-9,536,141097,858303,-0.001,0.054,14.11,85.83,141633,
leeHom,gen_n1000000_l174_merged.fq.gz,1000000,174,999914,999911,3,549,142873,856489,0.0,0.055,14.287,85.649,143422,
leeHom,gen_n1000000_l175_merged.fq.gz,1000000,175,999925,999927,-2,560,144924,854443,-0.0,0.056,14.492,85.444,145484,
leeHom,gen_n1000000_l176_merged.fq.gz,1000000,176,999930,999910,20,628,147663,851619,0.002,0.063,14.766,85.162,148291,
leeHom,gen_n1000000_l177_merged.fq.gz,1000000,177,999920,999918,2,614,149913,849391,0.0,0.061,14.991,84.939,150527,
leeHom,gen_n1000000_l178_merged.fq.gz,1000000,178,999916,999910,6,631,152173,847106,0.001,0.063,15.217,84.711,152804,
leeHom,gen_n1000000_l179_merged.fq.gz,1000000,179,999920,999908,12,621,154613,844674,0.001,0.062,15.461,84.467,155234,
leeHom,gen_n1000000_l17_merged.fq.gz,1000000,17,999905,1000000,-95,0,3728,996272,-0.009,0.0,0.373,99.627,3728,
leeHom,gen_n1000000_l180_merged.fq.gz,1000000,180,999915,999904,11,670,156739,842495,0.001,0.067,15.674,84.249,157409,
leeHom,gen_n1000000_l181_merged.fq.gz,1000000,181,999924,999897,27,712,159300,839885,0.003,0.071,15.93,83.989,160012,
leeHom,gen_n1000000_l182_merged.fq.gz,1000000,182,999910,999898,12,705,161471,837722,0.001,0.071,16.147,83.772,162176,
leeHom,gen_n1000000_l183_merged.fq.gz,1000000,183,999924,999903,21,776,163394,835733,0.002,0.078,16.339,83.573,164170,
leeHom,gen_n1000000_l184_merged.fq.gz,1000000,184,999926,999884,42,812,166104,832968,0.004,0.081,16.61,83.297,166916,
leeHom,gen_n1000000_l185_merged.fq.gz,1000000,185,999927,999887,40,880,168681,830326,0.004,0.088,16.868,83.033,169561,
leeHom,gen_n1000000_l186_merged.fq.gz,1000000,186,999915,999874,41,916,171169,827789,0.004,0.092,17.117,82.779,172085,
leeHom,gen_n1000000_l187_merged.fq.gz,1000000,187,999925,999885,40,977,173357,825551,0.004,0.098,17.336,82.555,174334,
leeHom,gen_n1000000_l188_merged.fq.gz,1000000,188,999917,999886,31,1052,175623,823211,0.003,0.105,17.562,82.321,176675,
leeHom,gen_n1000000_l189_merged.fq.gz,1000000,189,999930,999863,67,1041,177568,821254,0.007,0.104,17.757,82.125,178609,
leeHom,gen_n1000000_l18_merged.fq.gz,1000000,18,999914,1000000,-86,0,3845,996155,-0.009,0.0,0.385,99.615,3845,
leeHom,gen_n1000000_l190_merged.fq.gz,1000000,190,999924,999849,75,1089,180567,818193,0.007,0.109,18.057,81.819,181656,
leeHom,gen_n1000000_l191_merged.fq.gz,1000000,191,999921,999877,44,1056,182928,815893,0.004,0.106,18.293,81.589,183984,
leeHom,gen_n1000000_l192_merged.fq.gz,1000000,192,999907,999859,48,1138,186330,812391,0.005,0.114,18.633,81.239,187468,
leeHom,gen_n1000000_l193_merged.fq.gz,1000000,193,999920,999868,52,1162,187633,811073,0.005,0.116,18.763,81.107,188795,
leeHom,gen_n1000000_l194_merged.fq.gz,1000000,194,999925,999834,91,1174,189354,809306,0.009,0.117,18.935,80.931,190528,
leeHom,gen_n1000000_l195_merged.fq.gz,1000000,195,999921,999840,81,1190,192841,805809,0.008,0.119,19.284,80.581,194031,
leeHom,gen_n1000000_l196_merged.fq.gz,1000000,196,999940,999842,98,1238,195934,802670,0.01,0.124,19.593,80.267,197172,
leeHom,gen_n1000000_l197_merged.fq.gz,1000000,197,999919,999806,113,1282,198577,799947,0.011,0.128,19.858,79.995,199859,
leeHom,gen_n1000000_l198_merged.fq.gz,1000000,198,999913,999791,122,1336,200777,797678,0.012,0.134,20.078,79.768,202113,
leeHom,gen_n1000000_l199_merged.fq.gz,1000000,199,999921,999803,118,1267,203793,794743,0.012,0.127,20.379,79.474,205060,
leeHom,gen_n1000000_l19_merged.fq.gz,1000000,19,999898,1000000,-102,0,4030,995970,-0.01,0.0,0.403,99.597,4030,
leeHom,gen_n1000000_l1_merged.fq.gz,1000000,1,999924,1000000,-76,0,458,999542,-0.008,0.0,0.046,99.954,458,
leeHom,gen_n1000000_l200_merged.fq.gz,1000000,200,999912,999804,108,1350,205924,792530,0.011,0.135,20.592,79.253,207274,
leeHom,gen_n1000000_l201_merged.fq.gz,1000000,201,999934,999770,164,1410,208424,789936,0.016,0.141,20.842,78.994,209834,
leeHom,gen_n1000000_l202_merged.fq.gz,1000000,202,999919,999746,173,1388,211514,786844,0.017,0.139,21.151,78.684,212902,
leeHom,gen_n1000000_l203_merged.fq.gz,1000000,203,999910,999768,142,1489,214305,783974,0.014,0.149,21.43,78.397,215794,
leeHom,gen_n1000000_l204_merged.fq.gz,1000000,204,999907,999713,194,1567,217063,781083,0.019,0.157,21.706,78.108,218630,
leeHom,gen_n1000000_l205_merged.fq.gz,1000000,205,999929,999660,269,1590,220136,777934,0.027,0.159,22.014,77.793,221726,
leeHom,gen_n1000000_l206_merged.fq.gz,1000000,206,999928,999638,290,1552,221965,776121,0.029,0.155,22.197,77.612,223517,
leeHom,gen_n1000000_l207_merged.fq.gz,1000000,207,999924,999636,288,1686,224604,773346,0.029,0.169,22.46,77.335,226290,
leeHom,gen_n1000000_l208_merged.fq.gz,1000000,208,999926,999609,317,1697,228126,769786,0.032,0.17,22.813,76.979,229823,
leeHom,gen_n1000000_l209_merged.fq.gz,1000000,209,999910,999578,332,1849,231122,766607,0.033,0.185,23.112,76.661,232971,
leeHom,gen_n1000000_l20_merged.fq.gz,1000000,20,999917,1000000,-83,0,4426,995574,-0.008,0.0,0.443,99.557,4426,
leeHom,gen_n1000000_l210_merged.fq.gz,1000000,210,999916,999522,394,2019,233220,764283,0.039,0.202,23.322,76.428,235239,
leeHom,gen_n1000000_l211_merged.fq.gz,1000000,211,999931,999489,442,1956,236700,760833,0.044,0.196,23.67,76.083,238656,
leeHom,gen_n1000000_l212_merged.fq.gz,1000000,212,999910,999445,465,1922,239250,758273,0.046,0.192,23.925,75.827,241172,
leeHom,gen_n1000000_l213_merged.fq.gz,1000000,213,999900,999450,450,2059,241098,756293,0.045,0.206,24.11,75.629,243157,
leeHom,gen_n1000000_l214_merged.fq.gz,1000000,214,999937,999365,572,2168,244582,752615,0.057,0.217,24.458,75.261,246750,
leeHom,gen_n1000000_l215_merged.fq.gz,1000000,215,999920,999316,604,2213,247711,749392,0.06,0.221,24.771,74.939,249924,
leeHom,gen_n1000000_l216_merged.fq.gz,1000000,216,999907,999282,625,2266,249716,747300,0.062,0.227,24.972,74.73,251982,
leeHom,gen_n1000000_l217_merged.fq.gz,1000000,217,999922,999144,778,2404,253582,743158,0.078,0.24,25.358,74.316,255986,
leeHom,gen_n1000000_l218_merged.fq.gz,1000000,218,999919,999150,769,2364,256908,739878,0.077,0.236,25.691,73.988,259272,
leeHom,gen_n1000000_l219_merged.fq.gz,1000000,219,999918,999032,886,2539,258967,737526,0.089,0.254,25.897,73.753,261506,
leeHom,gen_n1000000_l21_merged.fq.gz,1000000,21,999934,1000000,-66,0,4559,995441,-0.007,0.0,0.456,99.544,4559,
leeHom,gen_n1000000_l220_merged.fq.gz,1000000,220,999916,999021,895,2737,261732,734552,0.089,0.274,26.173,73.455,264469,
leeHom,gen_n1000000_l221_merged.fq.gz,1000000,221,999924,998874,1050,2732,265223,730919,0.105,0.273,26.522,73.092,267955,
leeHom,gen_n1000000_l222_merged.fq.gz,1000000,222,999924,998768,1156,2909,268249,727610,0.116,0.291,26.825,72.761,271158,
leeHom,gen_n1000000_l223_merged.fq.gz,1000000,223,999932,998632,1300,3069,271682,723881,0.13,0.307,27.168,72.388,274751,
leeHom,gen_n1000000_l224_merged.fq.gz,1000000,224,999922,998591,1331,3032,273479,722080,0.133,0.303,27.348,72.208,276511,
leeHom,gen_n1000000_l225_merged.fq.gz,1000000,225,999911,998431,1480,3259,277723,717449,0.148,0.326,27.772,71.745,280982,
leeHom,gen_n1000000_l226_merged.fq.gz,1000000,226,999920,998318,1602,3401,280220,714697,0.16,0.34,28.022,71.47,283621,
leeHom,gen_n1000000_l227_merged.fq.gz,1000000,227,999921,998119,1802,3515,282641,711963,0.18,0.351,28.264,71.196,286156,
leeHom,gen_n1000000_l228_merged.fq.gz,1000000,228,999925,998003,1922,3532,287398,707073,0.192,0.353,28.74,70.707,290930,
leeHom,gen_n1000000_l229_merged.fq.gz,1000000,229,999915,997792,2123,3851,289327,704614,0.212,0.385,28.933,70.461,293178,
leeHom,gen_n1000000_l22_merged.fq.gz,1000000,22,999918,1000000,-82,0,4693,995307,-0.008,0.0,0.469,99.531,4693,
leeHom,gen_n1000000_l230_merged.fq.gz,1000000,230,999909,997650,2259,4030,291912,701708,0.226,0.403,29.191,70.171,295942,
leeHom,gen_n1000000_l231_merged.fq.gz,1000000,231,999908,997370,2538,4176,295888,697306,0.254,0.418,29.589,69.731,300064,
leeHom,gen_n1000000_l232_merged.fq.gz,1000000,232,999927,997107,2820,4440,298579,694088,0.282,0.444,29.858,69.409,303019,
leeHom,gen_n1000000_l233_merged.fq.gz,1000000,233,999907,996731,3176,4795,301279,690657,0.318,0.479,30.128,69.066,306074,
leeHom,gen_n1000000_l234_merged.fq.gz,1000000,234,999922,996371,3551,4906,305150,686315,0.355,0.491,30.515,68.632,310056,
leeHom,gen_n1000000_l235_merged.fq.gz,1000000,235,999915,996004,3911,5241,306962,683801,0.391,0.524,30.696,68.38,312203,
leeHom,gen_n1000000_l236_merged.fq.gz,1000000,236,999917,995512,4405,5611,310584,679317,0.441,0.561,31.058,67.932,316195,
leeHom,gen_n1000000_l237_merged.fq.gz,1000000,237,999921,994925,4996,5992,313491,675442,0.5,0.599,31.349,67.544,319483,
leeHom,gen_n1000000_l238_merged.fq.gz,1000000,238,999925,994494,5431,6115,316055,672324,0.543,0.611,31.605,67.232,322170,
leeHom,gen_n1000000_l239_merged.fq.gz,1000000,239,999926,992741,7185,6722,318293,667726,0.719,0.672,31.829,66.773,325015,
leeHom,gen_n1000000_l23_merged.fq.gz,1000000,23,999913,1000000,-87,0,4864,995136,-0.009,0.0,0.486,99.514,4864,
leeHom,gen_n1000000_l240_merged.fq.gz,1000000,240,999921,14988,984933,14988,0,0,98.493,1.499,0.0,0.0,14988,
leeHom,gen_n1000000_l241_merged.fq.gz,1000000,241,999922,15155,984767,15155,0,0,98.477,1.516,0.0,0.0,15155,
leeHom,gen_n1000000_l242_merged.fq.gz,1000000,242,999910,15141,984769,15141,0,0,98.477,1.514,0.0,0.0,15141,
leeHom,gen_n1000000_l243_merged.fq.gz,1000000,243,999926,15233,984693,15233,0,0,98.469,1.523,0.0,0.0,15233,
leeHom,gen_n1000000_l244_merged.fq.gz,1000000,244,999921,14662,985259,14662,0,0,98.526,1.466,0.0,0.0,14662,
leeHom,gen_n1000000_l245_merged.fq.gz,1000000,245,999908,14048,985860,14048,0,0,98.586,1.405,0.0,0.0,14048,
leeHom,gen_n1000000_l246_merged.fq.gz,1000000,246,999926,14036,985890,14036,0,0,98.589,1.404,0.0,0.0,14036,
leeHom,gen_n1000000_l247_merged.fq.gz,1000000,247,999918,14143,985775,14143,0,0,98.578,1.414,0.0,0.0,14143,
leeHom,gen_n1000000_l248_merged.fq.gz,1000000,248,999911,14188,985723,14188,0,0,98.572,1.419,0.0,0.0,14188,
leeHom,gen_n1000000_l249_merged.fq.gz,1000000,249,999912,14503,985409,14503,0,0,98.541,1.45,0.0,0.0,14503,
leeHom,gen_n1000000_l24_merged.fq.gz,1000000,24,999929,1000000,-71,0,5128,994872,-0.007,0.0,0.513,99.487,5128,
leeHom,gen_n1000000_l250_merged.fq.gz,1000000,250,999916,13966,985950,13966,0,0,98.595,1.397,0.0,0.0,13966,
leeHom,gen_n1000000_l25_merged.fq.gz,1000000,25,999922,999998,-76,0,5363,994635,-0.008,0.0,0.536,99.464,5363,
leeHom,gen_n1000000_l26_merged.fq.gz,1000000,26,999912,1000000,-88,0,5458,994542,-0.009,0.0,0.546,99.454,5458,
leeHom,gen_n1000000_l27_merged.fq.gz,1000000,27,999930,1000000,-70,0,5615,994385,-0.007,0.0,0.561,99.438,5615,
leeHom,gen_n1000000_l28_merged.fq.gz,1000000,28,999922,1000000,-78,0,5955,994045,-0.008,0.0,0.596,99.404,5955,
leeHom,gen_n1000000_l29_merged.fq.gz,1000000,29,999909,1000000,-91,0,6061,993939,-0.009,0.0,0.606,99.394,6061,
leeHom,gen_n1000000_l2_merged.fq.gz,1000000,2,999928,1000000,-72,0,914,999086,-0.007,0.0,0.091,99.909,914,
leeHom,gen_n1000000_l30_merged.fq.gz,1000000,30,999937,1000000,-63,0,6182,993818,-0.006,0.0,0.618,99.382,6182,
leeHom,gen_n1000000_l31_merged.fq.gz,1000000,31,999928,1000000,-72,0,6626,993374,-0.007,0.0,0.663,99.337,6626,
leeHom,gen_n1000000_l32_merged.fq.gz,1000000,32,999921,999999,-78,0,6752,993247,-0.008,0.0,0.675,99.325,6752,
leeHom,gen_n1000000_l33_merged.fq.gz,1000000,33,999929,1000000,-71,0,6846,993154,-0.007,0.0,0.685,99.315,6846,
leeHom,gen_n1000000_l34_merged.fq.gz,1000000,34,999934,1000000,-66,0,7112,992888,-0.007,0.0,0.711,99.289,7112,
leeHom,gen_n1000000_l35_merged.fq.gz,1000000,35,999903,1000000,-97,0,7338,992662,-0.01,0.0,0.734,99.266,7338,
leeHom,gen_n1000000_l36_merged.fq.gz,1000000,36,999918,1000000,-82,0,7413,992587,-0.008,0.0,0.741,99.259,7413,
leeHom,gen_n1000000_l37_merged.fq.gz,1000000,37,999921,1000000,-79,0,7801,992199,-0.008,0.0,0.78,99.22,7801,
leeHom,gen_n1000000_l38_merged.fq.gz,1000000,38,999917,1000000,-83,0,8069,991931,-0.008,0.0,0.807,99.193,8069,
leeHom,gen_n1000000_l39_merged.fq.gz,1000000,39,999919,1000000,-81,0,8324,991676,-0.008,0.0,0.832,99.168,8324,
leeHom,gen_n1000000_l3_merged.fq.gz,1000000,3,999926,1000000,-74,0,1397,998603,-0.007,0.0,0.14,99.86,1397,
leeHom,gen_n1000000_l40_merged.fq.gz,1000000,40,999920,1000000,-80,0,8232,991768,-0.008,0.0,0.823,99.177,8232,
leeHom,gen_n1000000_l41_merged.fq.gz,1000000,41,999900,1000000,-100,0,8780,991220,-0.01,0.0,0.878,99.122,8780,
leeHom,gen_n1000000_l42_merged.fq.gz,1000000,42,999906,999999,-93,0,8796,991203,-0.009,0.0,0.88,99.12,8796,
leeHom,gen_n1000000_l43_merged.fq.gz,1000000,43,999921,1000000,-79,0,8949,991051,-0.008,0.0,0.895,99.105,8949,
leeHom,gen_n1000000_l44_merged.fq.gz,1000000,44,999910,999999,-89,0,9143,990856,-0.009,0.0,0.914,99.086,9143,
leeHom,gen_n1000000_l45_merged.fq.gz,1000000,45,999912,1000000,-88,0,9525,990475,-0.009,0.0,0.953,99.047,9525,
leeHom,gen_n1000000_l46_merged.fq.gz,1000000,46,999923,999999,-76,0,9650,990349,-0.008,0.0,0.965,99.035,9650,
leeHom,gen_n1000000_l47_merged.fq.gz,1000000,47,999928,1000000,-72,0,9785,990215,-0.007,0.0,0.979,99.021,9785,
leeHom,gen_n1000000_l48_merged.fq.gz,1000000,48,999923,1000000,-77,0,10244,989756,-0.008,0.0,1.024,98.976,10244,
leeHom,gen_n1000000_l49_merged.fq.gz,1000000,49,999925,1000000,-75,0,10221,989779,-0.007,0.0,1.022,98.978,10221,
leeHom,gen_n1000000_l4_merged.fq.gz,1000000,4,999896,1000000,-104,0,1753,998247,-0.01,0.0,0.175,99.825,1753,
leeHom,gen_n1000000_l50_merged.fq.gz,1000000,50,999927,1000000,-73,0,10715,989285,-0.007,0.0,1.072,98.928,10715,
leeHom,gen_n1000000_l51_merged.fq.gz,1000000,51,999919,1000000,-81,0,10500,989500,-0.008,0.0,1.05,98.95,10500,
leeHom,gen_n1000000_l52_merged.fq.gz,1000000,52,999920,1000000,-80,0,11102,988898,-0.008,0.0,1.11,98.89,11102,
leeHom,gen_n1000000_l53_merged.fq.gz,1000000,53,999912,1000000,-88,0,11085,988915,-0.009,0.0,1.109,98.891,11085,
leeHom,gen_n1000000_l54_merged.fq.gz,1000000,54,999922,1000000,-78,0,11192,988808,-0.008,0.0,1.119,98.881,11192,
leeHom,gen_n1000000_l55_merged.fq.gz,1000000,55,999914,1000000,-86,0,11580,988420,-0.009,0.0,1.158,98.842,11580,
leeHom,gen_n1000000_l56_merged.fq.gz,1000000,56,999916,1000000,-84,0,11829,988171,-0.008,0.0,1.183,98.817,11829,
leeHom,gen_n1000000_l57_merged.fq.gz,1000000,57,999900,1000000,-100,0,12023,987977,-0.01,0.0,1.202,98.798,12023,
leeHom,gen_n1000000_l58_merged.fq.gz,1000000,58,999915,1000000,-85,0,12284,987716,-0.009,0.0,1.228,98.772,12284,
leeHom,gen_n1000000_l59_merged.fq.gz,1000000,59,999905,1000000,-95,0,12478,987522,-0.009,0.0,1.248,98.752,12478,
leeHom,gen_n1000000_l5_merged.fq.gz,1000000,5,999925,1000000,-75,0,2240,997760,-0.007,0.0,0.224,99.776,2240,
leeHom,gen_n1000000_l60_merged.fq.gz,1000000,60,999917,1000000,-83,0,12636,987364,-0.008,0.0,1.264,98.736,12636,
leeHom,gen_n1000000_l61_merged.fq.gz,1000000,61,999918,1000000,-82,0,12761,987239,-0.008,0.0,1.276,98.724,12761,
leeHom,gen_n1000000_l62_merged.fq.gz,1000000,62,999910,1000000,-90,0,12862,987138,-0.009,0.0,1.286,98.714,12862,
leeHom,gen_n1000000_l63_merged.fq.gz,1000000,63,999911,1000000,-89,0,13042,986958,-0.009,0.0,1.304,98.696,13042,
leeHom,gen_n1000000_l64_merged.fq.gz,1000000,64,999922,1000000,-78,0,13626,986374,-0.008,0.0,1.363,98.637,13626,
leeHom,gen_n1000000_l65_merged.fq.gz,1000000,65,999920,1000000,-80,0,13816,986184,-0.008,0.0,1.382,98.618,13816,
leeHom,gen_n1000000_l66_merged.fq.gz,1000000,66,999904,1000000,-96,0,13881,986119,-0.01,0.0,1.388,98.612,13881,
leeHom,gen_n1000000_l67_merged.fq.gz,1000000,67,999925,1000000,-75,0,14076,985924,-0.007,0.0,1.408,98.592,14076,
leeHom,gen_n1000000_l68_merged.fq.gz,1000000,68,999915,1000000,-85,0,14365,985635,-0.009,0.0,1.436,98.564,14365,
leeHom,gen_n1000000_l69_merged.fq.gz,1000000,69,999916,1000000,-84,0,14424,985576,-0.008,0.0,1.442,98.558,14424,
leeHom,gen_n1000000_l6_merged.fq.gz,1000000,6,999916,1000000,-84,0,2248,997752,-0.008,0.0,0.225,99.775,2248,
leeHom,gen_n1000000_l70_merged.fq.gz,1000000,70,999901,1000000,-99,0,14847,985153,-0.01,0.0,1.485,98.515,14847,
leeHom,gen_n1000000_l71_merged.fq.gz,1000000,71,999895,1000000,-105,0,15210,984790,-0.011,0.0,1.521,98.479,15210,
leeHom,gen_n1000000_l72_merged.fq.gz,1000000,72,999909,1000000,-91,0,15664,984336,-0.009,0.0,1.566,98.434,15664,
leeHom,gen_n1000000_l73_merged.fq.gz,1000000,73,999926,1000000,-74,0,15622,984378,-0.007,0.0,1.562,98.438,15622,
leeHom,gen_n1000000_l74_merged.fq.gz,1000000,74,999914,1000000,-86,0,15876,984124,-0.009,0.0,1.588,98.412,15876,
leeHom,gen_n1000000_l75_merged.fq.gz,1000000,75,999929,1000000,-71,0,15882,984118,-0.007,0.0,1.588,98.412,15882,
leeHom,gen_n1000000_l76_merged.fq.gz,1000000,76,999914,999999,-85,0,16098,983901,-0.009,0.0,1.61,98.39,16098,
leeHom,gen_n1000000_l77_merged.fq.gz,1000000,77,999902,1000000,-98,0,16466,983534,-0.01,0.0,1.647,98.353,16466,
leeHom,gen_n1000000_l78_merged.fq.gz,1000000,78,999918,1000000,-82,0,16752,983248,-0.008,0.0,1.675,98.325,16752,
leeHom,gen_n1000000_l79_merged.fq.gz,1000000,79,999921,1000000,-79,0,16853,983147,-0.008,0.0,1.685,98.315,16853,
leeHom,gen_n1000000_l7_merged.fq.gz,1000000,7,999912,1000000,-88,0,2226,997774,-0.009,0.0,0.223,99.777,2226,
leeHom,gen_n1000000_l80_merged.fq.gz,1000000,80,999907,1000000,-93,0,16924,983076,-0.009,0.0,1.692,98.308,16924,
leeHom,gen_n1000000_l81_merged.fq.gz,1000000,81,999923,1000000,-77,0,17210,982790,-0.008,0.0,1.721,98.279,17210,
leeHom,gen_n1000000_l82_merged.fq.gz,1000000,82,999924,1000000,-76,0,17807,982193,-0.008,0.0,1.781,98.219,17807,
leeHom,gen_n1000000_l83_merged.fq.gz,1000000,83,999923,1000000,-77,0,17526,982474,-0.008,0.0,1.753,98.247,17526,
leeHom,gen_n1000000_l84_merged.fq.gz,1000000,84,999906,1000000,-94,0,17843,982157,-0.009,0.0,1.784,98.216,17843,
leeHom,gen_n1000000_l85_merged.fq.gz,1000000,85,999916,1000000,-84,0,18327,981673,-0.008,0.0,1.833,98.167,18327,
leeHom,gen_n1000000_l86_merged.fq.gz,1000000,86,999921,1000000,-79,0,18625,981375,-0.008,0.0,1.862,98.138,18625,
leeHom,gen_n1000000_l87_merged.fq.gz,1000000,87,999935,1000000,-65,0,18982,981018,-0.006,0.0,1.898,98.102,18982,
leeHom,gen_n1000000_l88_merged.fq.gz,1000000,88,999924,1000000,-76,0,18803,981197,-0.008,0.0,1.88,98.12,18803,
leeHom,gen_n1000000_l89_merged.fq.gz,1000000,89,999911,1000000,-89,0,18902,981098,-0.009,0.0,1.89,98.11,18902,
leeHom,gen_n1000000_l8_merged.fq.gz,1000000,8,999921,1000000,-79,0,2326,997674,-0.008,0.0,0.233,99.767,2326,
leeHom,gen_n1000000_l90_merged.fq.gz,1000000,90,999923,1000000,-77,0,19153,980847,-0.008,0.0,1.915,98.085,19153,
leeHom,gen_n1000000_l91_merged.fq.gz,1000000,91,999915,1000000,-85,0,19542,980458,-0.009,0.0,1.954,98.046,19542,
leeHom,gen_n1000000_l92_merged.fq.gz,1000000,92,999916,1000000,-84,0,19799,980201,-0.008,0.0,1.98,98.02,19799,
leeHom,gen_n1000000_l93_merged.fq.gz,1000000,93,999908,1000000,-92,0,20172,979828,-0.009,0.0,2.017,97.983,20172,
leeHom,gen_n1000000_l94_merged.fq.gz,1000000,94,999916,1000000,-84,0,20360,979640,-0.008,0.0,2.036,97.964,20360,
leeHom,gen_n1000000_l95_merged.fq.gz,1000000,95,999918,1000000,-82,0,20622,979378,-0.008,0.0,2.062,97.938,20622,
leeHom,gen_n1000000_l96_merged.fq.gz,1000000,96,999915,1000000,-85,0,20919,979081,-0.009,0.0,2.092,97.908,20919,
leeHom,gen_n1000000_l97_merged.fq.gz,1000000,97,999915,1000000,-85,0,21091,978909,-0.009,0.0,2.109,97.891,21091,
leeHom,gen_n1000000_l98_merged.fq.gz,1000000,98,999919,1000000,-81,0,21510,978490,-0.008,0.0,2.151,97.849,21510,
leeHom,gen_n1000000_l99_merged.fq.gz,1000000,99,999915,1000000,-85,0,21684,978316,-0.009,0.0,2.168,97.832,21684,
leeHom,gen_n1000000_l9_merged.fq.gz,1000000,9,999911,1000000,-89,0,2307,997693,-0.009,0.0,0.231,99.769,2307,
